code departement,ABCDE_H,ABCDE_F,ABCDE,ABC_FR,ABC_E,ABC_2649,ABC_DUR2,ABC_25,A_F
01,196,199,395,245,107,235,66,55,90
01,214,196,410,264,111,234,74,68,91
01,235,208,443,264,127,253,70,59,116
01,302,292,594,445,88,301,85,106,144
01,308,302,610,441,89,306,102,105,135
01,360,302,662,482,101,333,123,107,141
01,362,336,698,460,204,449,126,52,243
01,376,351,727,507,174,435,123,72,248
01,411,405,816,580,182,519,139,84,263
01,414,444,858,604,179,533,156,81,285
01,447,436,883,674,109,444,146,147,206
01,463,441,904,710,100,469,136,145,190
01,479,425,904,611,244,576,190,77,295
01,503,482,985,684,233,626,187,77,346
01,510,464,974,752,117,504,161,153,230
01,725,923,1648,1184,271,869,256,256,476
01,745,887,1632,1230,249,874,258,299,484
01,810,953,1763,1256,295,907,267,302,503
01,1553,1378,2931,1700,945,1632,447,402,673
01,1571,1435,3006,1677,997,1636,495,413,706
01,1680,1453,3133,1758,1065,1664,512,466,741
01,2443,2339,4782,3065,1081,2441,715,678,1208
01,2512,2396,4908,3282,1069,2576,810,786,1208
01,2622,2406,5028,3171,1155,2554,780,727,1278
02,229,227,456,,,246,58,84,144
02,232,214,446,392,13,227,64,80,134
02,244,224,468,404,20,262,69,66,142
02,580,676,1256,1064,121,662,187,246,381
02,594,681,1275,1060,128,678,192,229,363
02,611,694,1305,1082,140,693,175,228,384
02,645,626,1271,1081,37,621,170,232,387
02,674,606,1280,1088,27,587,195,267,402
02,693,610,1303,1124,23,633,190,250,388
02,752,799,1551,1314,81,782,230,259,444
02,788,850,1638,1351,80,792,224,257,485
02,794,843,1637,1378,70,804,241,300,505
02,947,907,1854,1614,72,946,265,309,509
02,964,938,1902,1639,69,947,277,318,524
02,975,914,1889,1694,47,973,267,345,546
02,1102,1185,2287,1641,403,1227,365,337,666
02,1116,1200,2316,1583,418,1188,357,329,667
02,1146,1215,2361,1732,355,1265,404,345,677
02,1998,1765,3763,2907,350,1894,564,584,1046
02,2032,1845,3877,3025,386,1973,568,600,1138
02,2060,1847,3907,3034,318,1980,542,606,1082
02,2227,2021,4248,3081,704,2181,631,611,1165
02,2281,2029,4310,3178,698,2225,574,633,1176
02,2290,2037,4327,3113,789,2241,675,623,1266
02,4106,3766,7872,6634,577,4083,1128,1488,2295
02,4164,3806,7970,6641,593,4178,1073,1377,2245
02,4223,3827,8050,6831,558,4206,1088,1555,2238
03,1330,1180,2510,1940,284,1244,389,420,659
03,1354,1172,2526,1927,268,1237,364,437,619
03,1412,1250,2662,2103,234,1337,365,451,680
03,1615,1681,3296,2482,489,1579,451,525,860
03,1647,1650,3297,2495,465,1591,479,514,884
03,1659,1667,3326,2516,465,1618,469,533,886
03,2127,2160,4287,3484,453,2199,589,692,1185
03,2159,2231,4390,3545,427,2239,657,668,1200
03,2176,2105,4281,3456,455,2127,621,728,1151
03,2212,2253,4465,3632,463,2285,611,713,1223
03,2245,2330,4575,3699,435,2325,676,691,1245
03,2265,2194,4459,3605,465,2215,647,749,1187
03,2269,2409,4678,3610,616,2254,639,765,1224
03,2305,2374,4679,3598,603,2238,663,756,1263
03,2339,2401,4740,3662,600,2334,677,762,1274
03,2460,2530,4990,4092,477,2502,696,822,1339
03,2495,2606,5101,4168,443,2537,749,805,1380
03,2525,2475,5000,4075,481,2450,722,843,1324
04,891,990,1881,1438,246,983,274,247,562
04,932,983,1915,1472,256,992,318,285,569
04,939,1005,1944,1461,246,963,274,267,529
04,1501,1476,2977,2224,457,1564,439,428,836
04,1514,1434,2948,2146,501,1511,464,424,788
04,1559,1493,3052,2214,487,1560,426,395,822
05,1816,2003,3819,2908,402,1911,593,565,935
05,1875,2080,3955,3088,352,2016,625,568,987
05,1989,2022,4011,3031,447,2021,587,608,967
06,218,244,462,348,57,237,80,77,147
06,222,241,463,344,59,233,73,82,137
06,224,235,459,331,64,226,84,75,135
06,517,593,1110,869,120,560,196,182,319
06,539,605,1144,880,132,573,200,181,329
06,544,618,1162,920,131,602,214,172,345
06,840,870,1710,1267,196,787,240,186,488
06,856,948,1804,1343,186,817,276,215,498
06,888,889,1777,1333,198,811,244,216,500
06,1631,1745,3376,2333,613,1703,437,367,1003
06,1736,1805,3541,2519,630,1829,512,408,1105
06,1775,1824,3599,2442,664,1799,521,384,1079
06,2567,2798,5365,3783,911,2615,787,703,1594
06,2642,2931,5573,3990,957,2785,890,769,1729
06,2702,2901,5603,3939,912,2683,841,801,1689
06,7401,7696,15097,10809,2890,7719,2187,1751,4659
06,7502,7938,15440,11197,2940,8099,2157,1786,4902
06,8038,8346,16384,11551,3210,8337,2465,1949,5372
06,21007,20342,41349,26292,10668,21881,5989,4611,12275
06,21230,20539,41769,26592,10727,22077,6054,4666,12381
06,21992,20676,42668,27853,10858,23141,6536,5031,12842
06,22261,20900,43161,28214,10940,23375,6623,5121,12970
06,22329,21822,44151,28444,10971,23302,6378,4943,13088
06,22856,21632,44488,28191,11533,23463,7126,5350,13505
06,23084,21847,44931,28518,11589,23673,7204,5409,13635
06,23363,22206,45569,30167,11131,24601,6980,5400,13676
06,24272,23227,47499,30476,11861,24958,7587,5736,14386
07,470,470,940,668,117,425,126,152,245
07,482,471,953,701,111,447,144,155,241
07,508,490,998,728,123,454,137,190,260
07,563,537,1100,813,204,564,142,189,315
07,599,568,1167,832,236,615,187,190,305
07,638,621,1259,919,229,672,184,224,328
07,870,893,1763,1403,228,948,288,271,498
07,898,910,1808,1425,237,947,261,260,530
07,918,934,1852,1444,210,920,256,297,492
07,1126,1045,2171,1618,394,1165,314,363,583
07,1226,1101,2327,1704,408,1227,312,365,589
07,1260,1132,2392,1803,441,1290,384,402,645
08,373,410,783,686,12,377,113,110,200
08,386,456,842,750,8,410,119,122,236
08,390,418,808,703,14,403,145,121,207
08,1345,1117,2462,2120,138,1319,393,351,650
08,1357,1125,2482,2175,135,1316,364,357,676
08,1363,1109,2472,2089,141,1268,365,372,644
08,3191,2683,5874,4863,543,3217,861,857,1602
08,3191,2756,5947,4882,563,3255,852,851,1660
08,3254,2752,6006,4913,594,3312,867,855,1692
09,360,394,754,620,73,396,114,98,229
09,385,402,787,641,86,420,114,105,242
09,404,413,817,639,82,405,115,116,227
09,589,606,1195,862,171,621,166,169,342
09,615,618,1233,912,172,625,180,188,352
09,634,630,1264,911,202,662,207,193,358
09,948,1128,2076,1526,284,1060,353,321,651
09,977,1188,2165,1558,298,1074,327,354,654
09,983,1086,2069,1499,282,1000,297,350,605
10,293,361,654,486,111,345,95,93,207
10,307,367,674,510,108,351,79,96,221
10,345,377,722,535,120,383,123,101,218
10,619,741,1360,1053,151,729,202,181,405
10,642,752,1394,1081,180,748,202,228,426
10,653,778,1431,1094,168,765,241,191,442
10,1036,1083,2119,1619,315,1095,308,324,690
10,1082,1153,2235,1690,352,1196,347,316,760
10,1089,1134,2223,1696,325,1170,377,327,736
10,4741,4581,9322,6906,1470,4991,1371,1515,2782
10,4854,4625,9479,7014,1544,5042,1364,1608,2856
10,4865,4755,9620,7177,1507,5254,1460,1561,2952
10,6006,5805,11811,8625,1995,6335,1715,1823,3532
10,6128,5894,12022,8801,2091,6428,1679,1959,3616
10,6143,6006,12149,8934,2042,6613,1844,1904,3763
11,492,589,1081,828,130,531,166,146,324
11,535,531,1066,869,88,505,142,163,281
11,538,551,1089,821,141,504,126,169,287
11,541,602,1143,865,112,519,177,166,342
11,560,524,1084,879,93,512,162,173,301
11,606,588,1194,980,81,557,187,211,323
11,2958,3170,6128,4235,1112,3001,803,842,1842
11,3081,3264,6345,4435,1154,3109,847,918,1953
11,3096,3336,6432,4558,1105,3168,954,912,1956
11,3715,4063,7778,5989,808,3758,1102,1181,2345
11,3816,4009,7825,6086,804,3913,1129,1153,2406
11,3825,4007,7832,6132,823,3798,1041,1215,2406
12,437,561,998,693,183,542,167,137,249
12,454,534,988,693,156,526,151,142,246
12,516,553,1069,806,114,508,161,140,262
12,525,565,1090,751,184,563,158,158,254
12,555,599,1154,859,135,530,158,189,271
12,586,568,1154,871,122,521,159,183,295
13,207,178,385,270,85,194,43,52,116
13,210,178,388,262,90,192,63,49,107
13,216,159,375,253,87,194,57,39,96
13,538,581,1119,934,51,537,167,198,336
13,553,577,1130,939,60,567,180,176,325
13,556,557,1113,937,57,568,158,172,311
13,990,868,1858,1246,458,927,243,249,496
13,1002,893,1895,1288,466,942,246,266,503
13,1022,1055,2077,1367,475,1072,291,272,590
13,1023,1025,2048,1334,478,1025,288,274,550
13,1024,933,1957,1322,480,992,281,256,497
13,1024,1149,2173,1777,168,1109,380,359,591
13,1043,1030,2073,1680,222,1025,340,333,599
13,1051,1156,2207,1846,164,1193,373,355,600
13,1062,1068,2130,1448,461,1048,309,328,571
13,1106,1008,2114,1699,235,1053,329,343,591
13,1108,1204,2312,1876,193,1166,334,393,626
13,1111,1081,2192,1804,214,1106,349,355,651
13,1155,898,2053,1103,767,1044,277,261,512
13,1169,947,2116,1109,826,1057,284,284,562
13,1201,880,2081,1198,728,1042,324,300,524
13,1740,1750,3490,2319,832,1878,542,547,924
13,1746,1877,3623,2803,395,1795,533,548,1024
13,1777,1764,3541,2395,801,1842,502,611,949
13,1795,1813,3608,2463,826,1950,547,586,1023
13,1843,2010,3853,3061,414,1944,627,660,1117
13,1873,1926,3799,2928,404,1879,615,617,1061
13,2017,2029,4046,3127,539,2076,618,655,1088
13,2108,2651,4759,3718,462,2492,760,783,1386
13,2120,2116,4236,3365,536,2263,696,642,1191
13,2130,2727,4857,3853,444,2540,806,850,1423
13,2196,2166,4362,3293,591,2204,706,690,1168
13,2254,2730,4984,3890,477,2589,800,840,1469
13,2351,2648,4999,3917,485,2528,737,722,1415
13,2384,2697,5081,3932,528,2574,715,756,1499
13,2487,2714,5201,4122,492,2725,804,773,1470
13,2694,2942,5636,4468,625,2981,799,829,1628
13,2712,2921,5633,4098,783,2767,850,809,1476
13,2789,3051,5840,4387,771,2948,895,845,1581
13,2802,2970,5772,4228,719,2851,858,801,1506
13,2823,3007,5830,4534,678,3001,843,839,1667
13,2837,3049,5886,4674,655,3158,900,904,1708
13,3550,3673,7223,5156,1306,3538,1039,1003,2087
13,3638,3655,7293,5217,1351,3621,1011,1003,2071
13,3679,3793,7472,5441,1274,3704,1085,1082,2201
13,6596,7095,13691,10341,1607,7195,2011,1745,3788
13,6729,7227,13956,10933,1570,7511,2128,1908,3998
13,7029,7391,14420,10986,1728,7542,2262,1921,4111
13,55491,51585,107076,78020,18673,58656,16329,13466,31219
13,55739,51856,107595,78448,18701,58902,16410,13556,31371
13,56938,52700,109638,80830,19195,61287,17517,14066,32392
13,57184,52971,110155,81249,19221,61521,17587,14143,32536
13,57796,52995,110791,79717,19603,59672,16119,14276,32362
13,58060,53297,111357,80161,19645,59936,16189,14362,32527
14,470,511,981,762,82,521,142,163,243
14,471,504,975,820,47,481,138,183,296
14,475,524,999,783,76,532,156,158,261
14,488,534,1022,847,43,489,139,192,299
14,489,531,1020,856,53,495,151,188,285
14,506,512,1018,811,89,544,133,180,254
14,1262,1233,2495,2098,140,1205,386,453,660
14,1265,1238,2503,2077,135,1199,359,429,655
14,1369,1342,2711,2266,161,1339,404,504,674
14,1518,1504,3022,2367,367,1673,446,539,806
14,1554,1463,3017,2376,336,1629,406,543,791
14,1559,1582,3141,2491,343,1731,519,588,833
14,7265,6108,13373,9912,1876,7343,1903,2221,3236
14,7335,6331,13666,10337,1919,7691,2101,2275,3386
14,7413,6116,13529,10043,1919,7483,1999,2155,3353
14,7551,6391,13942,10391,1917,7651,1978,2321,3371
14,7642,6627,14269,10861,1950,8039,2207,2373,3531
14,7715,6417,14132,10550,1956,7821,2098,2243,3498
14,7781,6720,14501,10839,1978,7997,2065,2408,3543
14,7878,6993,14871,11328,2036,8393,2281,2486,3705
14,7958,6742,14700,11009,2011,8133,2180,2351,3659
15,1110,1117,2227,1730,230,1110,308,358,491
15,1121,1078,2199,1688,252,1104,290,343,508
15,1148,1211,2359,1859,214,1178,369,382,539
16,349,505,854,714,56,433,125,132,254
16,393,503,896,737,52,448,125,135,240
16,407,489,896,734,63,438,126,139,223
16,640,655,1295,938,245,707,194,185,376
16,668,666,1334,980,247,740,205,185,360
16,675,659,1334,954,263,722,202,195,363
16,1102,1101,2203,1876,133,1166,349,375,552
16,1158,1173,2331,2009,145,1222,378,420,578
16,1169,1146,2315,1979,137,1221,339,397,568
16,3228,2944,6172,4796,865,3438,915,1006,1619
16,3299,3033,6332,4946,835,3496,1001,1022,1673
16,3329,2962,6291,4828,843,3446,852,995,1630
17,1004,1106,2110,1851,74,983,310,315,627
17,1007,1122,2129,1834,96,988,265,301,622
17,1009,1129,2138,1837,100,1002,249,305,653
17,1278,1489,2767,2299,166,1346,376,420,730
17,1345,1560,2905,2440,173,1451,468,437,791
17,1367,1494,2861,2370,193,1398,434,436,758
17,1497,1611,3108,2502,219,1457,463,465,803
17,1576,1685,3261,2681,215,1632,453,464,838
17,1580,1637,3217,2571,250,1534,473,484,838
17,4846,4661,9507,7659,879,4996,1368,1409,2400
17,5000,4737,9737,7955,863,5222,1429,1467,2458
17,5154,4949,10103,8085,935,5118,1398,1677,2618
18,459,484,943,820,28,431,136,161,244
18,473,483,956,828,34,424,130,163,263
18,507,510,1017,876,28,437,153,165,276
18,1714,1609,3323,2576,503,1693,501,526,949
18,1739,1646,3385,2600,486,1729,504,511,966
18,1760,1631,3391,2632,495,1727,470,557,949
18,3718,3650,7368,5538,1080,3893,1055,1079,2034
18,3789,3749,7538,5715,1072,4078,1055,1129,2088
18,3820,3696,7516,5673,1144,3953,1086,1152,1994
19,2479,2784,5263,3787,803,2736,804,749,1380
19,2552,2925,5477,3987,820,2808,792,818,1523
19,2553,2933,5486,3961,849,2882,827,820,1478
21,464,476,940,711,152,522,149,119,236
21,469,514,983,752,145,545,153,150,264
21,505,577,1082,777,194,554,165,146,310
21,513,589,1102,801,207,555,174,173,315
21,533,475,1008,768,146,542,147,145,229
21,540,605,1145,810,211,566,186,168,324
21,891,1004,1895,1469,208,1005,276,247,447
21,901,1067,1968,1549,211,1030,264,275,469
21,908,1072,1980,1502,229,988,292,282,492
21,938,931,1869,1230,477,1034,284,247,484
21,975,929,1904,1241,506,1038,296,261,497
21,987,980,1967,1289,544,1158,286,256,563
21,8096,7919,16015,11509,2812,8877,2313,2482,4016
21,8206,8166,16372,11999,2808,9255,2464,2540,4227
21,8538,8178,16716,11969,2881,9051,2641,2781,4039
22,464,596,1060,845,98,578,138,145,258
22,474,599,1073,883,96,568,154,180,290
22,509,609,1118,912,96,583,170,185,278
22,853,864,1717,1374,112,833,291,258,417
22,873,907,1780,1457,113,902,274,291,462
22,935,861,1796,1449,141,889,297,282,473
22,954,1001,1955,1553,159,966,305,284,498
22,978,985,1963,1587,160,975,270,299,484
22,998,1035,2033,1645,135,1020,302,297,513
22,2854,2960,5814,4297,894,3056,880,861,1538
22,2930,2949,5879,4356,878,3030,831,860,1589
22,3024,2963,5987,4451,910,3179,895,933,1518
23,667,608,1275,972,127,611,176,215,302
23,702,627,1329,1002,147,637,192,238,305
23,720,680,1400,1090,126,666,224,256,313
24,394,395,789,599,90,403,117,98,196
24,397,384,781,581,104,395,109,107,190
24,435,429,864,627,116,433,120,116,216
24,1705,1755,3460,2543,510,1686,478,486,921
24,1752,1770,3522,2564,559,1701,462,526,944
24,1761,1831,3592,2617,511,1734,495,537,925
24,2527,2183,4710,3509,608,2311,655,786,1150
24,2551,2270,4821,3625,625,2441,700,769,1218
24,2562,2181,4743,3532,619,2377,694,748,1195
25,342,268,610,447,108,341,84,88,138
25,353,260,613,432,124,345,99,88,133
25,362,327,689,521,93,386,125,98,194
25,380,324,704,510,113,397,91,86,170
25,399,302,701,502,131,396,97,112,159
25,412,332,744,526,128,404,119,109,177
25,425,372,797,575,141,464,138,100,223
25,427,263,690,463,171,387,131,116,150
25,434,333,767,542,156,435,138,122,184
25,633,579,1212,916,182,630,198,208,290
25,652,601,1253,937,215,655,213,212,328
25,719,599,1318,949,223,661,205,214,334
25,897,887,1784,1348,263,958,290,258,432
25,972,895,1867,1414,296,1053,352,258,440
25,1009,906,1915,1439,300,1051,305,279,487
25,1035,940,1975,1484,296,1074,293,303,512
25,1108,932,2040,1553,333,1156,388,315,508
25,1113,986,2099,1595,326,1164,411,301,476
25,1626,1520,3146,2199,617,1720,503,462,810
25,1696,1450,3146,2157,671,1720,491,486,805
25,1888,1505,3393,2268,792,1851,581,557,843
25,6873,6103,12976,9318,2352,7176,1960,1945,3352
25,6879,6192,13071,9411,2285,7274,2004,1960,3282
25,7105,6241,13346,9570,2361,7219,2075,2169,3276
26,313,417,730,531,135,369,113,119,206
26,323,396,719,531,124,360,103,118,181
26,333,408,741,546,130,363,98,128,213
26,338,461,799,527,209,440,117,133,247
26,338,461,799,557,190,431,124,158,265
26,411,476,887,576,237,472,137,144,266
26,790,976,1766,1384,255,974,266,284,546
26,791,983,1774,1391,261,958,285,285,544
26,807,977,1784,1359,278,928,257,296,557
26,2085,2092,4177,3156,713,2174,648,678,1119
26,2150,2099,4249,3124,742,2168,659,636,1122
26,2207,2247,4454,3402,723,2391,777,697,1208
26,2283,2664,4947,3690,776,2555,781,765,1379
26,2367,2775,5142,3872,800,2645,753,866,1586
26,2379,2676,5055,3829,791,2598,816,844,1461
26,4353,4391,8744,6257,1634,4794,1342,1247,2355
26,4472,4388,8860,6379,1609,4823,1309,1249,2441
26,4499,4443,8942,6438,1613,4953,1430,1293,2363
27,533,568,1101,955,64,544,165,221,305
27,536,572,1108,985,60,563,162,204,333
27,541,606,1147,1004,55,580,176,212,345
27,626,707,1333,1151,45,614,193,235,382
27,658,683,1341,1171,37,609,197,252,382
27,661,735,1396,1223,45,658,202,266,417
27,898,898,1796,1364,272,966,266,333,472
27,898,932,1830,1360,292,1015,299,320,473
27,967,971,1938,1488,291,1078,294,327,530
27,1275,1165,2440,1874,248,1213,334,433,590
27,1278,1107,2385,1814,253,1218,353,363,562
27,1289,1192,2481,1951,242,1263,365,430,614
27,1433,1422,2855,1958,658,1591,454,405,825
27,1434,1375,2809,1902,628,1514,434,407,771
27,1546,1474,3020,2016,705,1628,477,434,867
27,3432,3318,6750,4516,1571,3658,1031,1053,1855
27,3557,3411,6968,4697,1517,3761,1119,1037,1913
27,3582,3370,6952,4686,1650,3845,1069,1069,1985
28,537,572,1109,898,99,526,178,188,259
28,539,556,1095,899,107,523,179,202,258
28,544,574,1118,933,93,553,159,193,301
28,663,657,1320,888,295,697,178,171,332
28,673,679,1352,911,307,729,216,184,355
28,679,703,1382,920,325,781,217,172,368
28,716,725,1441,1008,275,762,229,236,427
28,723,649,1372,959,258,705,216,215,369
28,724,665,1389,951,283,734,188,204,396
28,821,781,1602,1158,275,890,225,220,452
28,824,831,1655,1222,282,946,247,223,485
28,868,854,1722,1257,280,962,288,253,507
28,1024,1176,2200,1549,449,1218,328,313,608
28,1032,1183,2215,1590,424,1243,353,306,622
28,1077,1194,2271,1630,439,1272,340,324,661
28,2148,2221,4369,3223,711,2309,653,650,1195
28,2210,2206,4416,3264,717,2288,697,722,1151
28,2278,2299,4577,3403,712,2463,687,725,1225
28,2354,2332,4686,3228,1031,2687,741,682,1458
28,2356,2327,4683,3192,1068,2688,703,647,1432
28,2388,2249,4637,3116,1084,2621,657,618,1336
28,3180,3158,6338,4414,1350,3634,950,870,1917
28,3209,3030,6239,4274,1359,3511,882,838,1788
28,3222,3186,6408,4485,1311,3649,1029,935,1965
29,991,1043,2034,1710,57,990,314,258,523
29,1024,1093,2117,1798,52,997,266,316,569
29,1059,1137,2196,1855,67,1034,291,314,555
29,3372,3454,6826,5337,618,3462,946,1031,1666
29,3392,3423,6815,5319,628,3532,988,1016,1600
29,3529,3511,7040,5637,592,3693,1108,1104,1714
29,7856,7770,15626,12076,1595,8366,2206,2638,3937
29,8004,7938,15942,12337,1700,8417,2211,2886,4158
29,8112,7984,16096,12643,1575,8718,2493,2809,4096
2A,740,1002,1742,1008,520,913,158,244,811
2A,766,1042,1808,1039,592,971,99,280,864
2A,841,1067,1908,1140,602,1054,130,294,870
2A,2271,2440,4711,3316,711,2256,695,610,1531
2A,2349,2494,4843,3351,803,2357,612,645,1576
2A,2398,2570,4968,3432,822,2412,654,670,1642
2B,1332,1501,2833,1930,478,1388,381,415,944
2B,1359,1504,2863,1985,480,1412,428,394,926
2B,1466,1557,3023,2088,534,1538,412,415,1001
30,213,252,465,396,18,218,63,50,156
30,225,266,491,422,26,234,84,63,179
30,243,257,500,426,29,241,67,57,161
30,244,239,483,437,21,249,61,65,171
30,250,226,476,421,22,237,71,66,144
30,254,257,511,447,23,247,74,63,166
30,419,316,735,587,84,383,113,72,223
30,422,335,757,615,88,404,114,89,236
30,436,312,748,585,85,368,110,80,213
30,447,460,907,738,100,485,113,101,297
30,458,452,910,725,94,460,158,115,276
30,497,467,964,762,93,484,151,123,284
30,628,652,1280,994,180,657,186,191,381
30,642,668,1310,1013,185,670,186,204,416
30,670,697,1367,1073,189,710,187,223,431
30,853,766,1619,1151,310,788,192,259,453
30,855,853,1708,1191,321,845,205,268,500
30,880,868,1748,1249,334,911,251,275,498
30,1217,1171,2388,1777,422,1219,403,399,699
30,1243,1169,2412,1792,391,1199,371,402,692
30,1247,1167,2414,1775,436,1253,354,383,686
30,1272,1149,2421,1334,922,1231,290,343,771
30,1304,1143,2447,1384,937,1256,306,377,743
30,1319,1180,2499,1397,925,1277,305,390,747
30,1670,1577,3247,1680,1314,1689,427,431,995
30,1709,1576,3285,1784,1256,1751,432,447,999
30,1743,1631,3374,1728,1435,1791,452,460,1074
30,2837,2964,5801,4374,774,2812,792,776,1766
30,2908,2953,5861,4547,748,2879,827,812,1886
30,3013,3091,6104,4634,746,3022,917,835,1852
30,10541,9341,19882,13842,4010,10181,2985,2771,5748
30,10565,9315,19880,13990,4051,10196,2727,2818,5743
30,10863,9451,20314,14258,3876,10524,3000,2889,5705
31,623,696,1319,978,179,598,184,229,384
31,627,690,1317,990,195,624,195,208,391
31,666,729,1395,1063,157,631,197,256,396
31,869,1089,1958,1461,297,1100,311,283,557
31,933,1085,2018,1483,334,1146,320,278,572
31,1006,1198,2204,1599,369,1210,344,340,657
31,1193,1424,2617,1859,470,1417,421,384,700
31,1205,1434,2639,1896,447,1463,387,376,715
31,1385,1557,2942,2152,454,1495,453,425,764
31,1401,1498,2899,2095,506,1566,453,475,852
31,1413,1659,3072,2289,436,1540,499,476,801
31,1482,1606,3088,2239,516,1532,487,468,818
31,1780,2005,3785,2662,679,2107,584,492,1005
31,1811,2049,3860,2717,698,2105,602,543,1037
31,2062,2196,4258,2992,830,2357,714,636,1217
31,32012,32526,64538,43702,13870,37503,9626,9073,17228
31,32463,33297,65760,45354,13514,38524,10120,9310,17613
31,35448,34505,69953,47435,15302,40532,11014,10666,19412
32,1139,1042,2181,1531,334,1031,318,323,535
32,1205,1106,2311,1627,334,1112,343,373,522
32,1209,1054,2263,1579,361,1060,305,362,514
33,413,581,994,842,57,496,150,136,314
33,427,459,886,627,144,434,132,147,227
33,427,480,907,672,135,479,118,140,221
33,432,589,1021,878,43,483,154,174,322
33,455,498,953,675,163,454,153,162,238
33,460,577,1037,871,68,507,170,167,305
33,490,458,948,567,305,468,121,141,251
33,496,476,972,588,313,492,124,139,247
33,502,481,983,624,290,516,160,135,267
33,1051,1064,2115,1592,238,1138,327,299,519
33,1068,1026,2094,1452,244,1049,255,258,496
33,1135,1180,2315,1510,554,1314,338,286,608
33,1140,1299,2439,1772,373,1360,363,304,659
33,1142,1063,2205,1572,275,1104,296,335,521
33,1143,1215,2358,1629,551,1383,371,327,689
33,1168,1201,2369,1515,624,1310,368,328,642
33,1214,1434,2648,1891,392,1388,402,374,726
33,1226,1378,2604,1936,371,1470,415,341,718
33,1772,1789,3561,2209,945,1979,529,515,987
33,1779,1869,3648,2473,659,2016,521,507,934
33,1805,1976,3781,2574,696,2046,573,561,1042
33,1829,1883,3712,2564,661,2040,568,528,970
33,1845,1866,3711,2391,944,2098,573,572,1003
33,1863,1877,3740,2371,973,2033,603,597,1060
33,1989,2126,4115,2950,616,2167,585,667,1052
33,2042,2122,4164,2996,645,2290,575,645,1088
33,2142,2517,4659,3399,632,2536,664,549,1271
33,2174,2246,4420,3196,675,2308,616,786,1129
33,2231,2609,4840,3646,606,2697,731,599,1337
33,2326,2638,4964,3595,668,2565,729,661,1327
33,2613,2900,5513,3869,948,2931,836,799,1422
33,2667,2917,5584,3972,940,3042,817,787,1423
33,2765,2925,5690,4088,978,3008,899,879,1501
33,2901,3111,6012,3918,1453,3339,842,846,1684
33,2972,3194,6166,4194,1492,3545,985,947,1828
33,3014,3214,6228,4035,1541,3386,965,922,1753
33,3288,3671,6959,5201,976,3842,997,972,1781
33,3303,3807,7110,5425,942,3945,1087,1068,1933
33,3472,3817,7289,5374,1078,3964,1089,1027,1948
33,16819,16321,33140,23222,6010,18972,4928,4472,8396
33,17100,16738,33838,24333,5930,19857,5190,4633,8786
33,17783,16980,34763,24606,6210,19598,5201,5086,9069
33,18585,18252,36837,25630,6909,20997,5432,5032,9472
33,18598,18190,36788,25695,6669,20988,5449,4979,9330
33,18929,18621,37550,26897,6591,21897,5758,5161,9756
33,18929,18717,37646,26898,6871,22019,5804,5253,9925
33,19588,18956,38544,27180,6906,21644,5774,5647,10111
33,19629,18993,38622,27126,7127,21674,5798,5680,10180
34,364,380,744,635,36,378,93,104,222
34,366,400,766,638,47,390,102,97,254
34,371,382,753,633,47,385,112,113,227
34,581,572,1153,899,126,585,187,146,333
34,591,556,1147,910,121,568,143,152,333
34,593,563,1156,916,132,588,179,156,336
34,1370,1411,2781,2259,189,1294,366,415,742
34,1444,1479,2923,2419,189,1422,407,436,807
34,1491,1430,2921,2378,203,1374,372,444,789
34,2145,2003,4148,2710,1034,2104,619,543,1140
34,2150,2040,4190,2790,1007,2131,592,552,1216
34,2264,2078,4342,2946,977,2266,628,589,1193
34,2574,2606,5180,4326,449,2543,610,684,1807
34,2621,2632,5253,4389,433,2594,588,733,1839
34,2670,2673,5343,4423,478,2501,643,738,1873
34,3140,3031,6171,4925,687,3125,793,739,1765
34,3149,3091,6240,5014,692,3115,827,738,1907
34,3202,3130,6332,4990,750,3232,908,785,1827
34,6082,5378,11460,8076,2160,5959,1605,1607,3439
34,6300,5485,11785,8398,2119,6147,1785,1695,3504
34,6458,5608,12066,8620,2304,6251,1753,1832,3641
34,21723,19971,41694,29879,7736,23949,6053,6290,11624
34,21981,20162,42143,30356,7647,24293,6394,6440,11761
34,22738,20584,43322,31227,7986,24729,6213,6712,12139
35,472,488,960,796,56,449,145,173,237
35,481,506,987,825,49,460,138,183,257
35,505,496,1001,826,61,484,161,184,231
35,2350,2424,4774,3959,250,2331,684,714,1172
35,2356,2474,4830,4059,249,2436,714,734,1255
35,2502,2507,5009,4171,295,2441,745,798,1310
35,13072,11858,24930,17892,4373,14716,3922,4033,5890
35,13203,11855,25058,17417,4637,14573,3769,3878,5822
35,14109,12170,26279,18107,4995,15114,3986,4223,6248
36,624,574,1198,1064,60,565,183,265,293
36,659,611,1270,1091,75,604,189,266,292
36,721,661,1382,1092,80,580,201,273,333
36,2719,2675,5394,3937,914,2841,771,831,1405
36,2888,2885,5773,4243,934,3017,872,933,1547
36,2933,2716,5649,4002,988,2868,829,916,1441
37,571,586,1157,840,177,606,156,190,278
37,598,587,1185,882,189,653,193,190,287
37,613,616,1229,896,196,672,205,201,277
37,736,871,1607,1289,172,836,244,262,471
37,744,871,1615,1320,167,850,206,261,464
37,783,846,1629,1300,182,829,220,279,453
37,1121,1048,2169,1471,504,1207,303,309,532
37,1127,1102,2229,1512,515,1241,310,339,547
37,1143,1024,2167,1471,529,1199,316,320,545
37,2117,2177,4294,3034,838,2323,673,702,1174
37,2137,2179,4316,3013,895,2344,648,722,1128
37,2167,2295,4462,3079,919,2441,656,726,1237
37,8752,8673,17425,12196,3237,9672,2592,2732,4399
37,8954,9283,18237,12833,3446,10179,2667,2997,4816
37,9136,8833,17969,12649,3403,9897,2680,3023,4525
38,196,223,419,312,57,222,61,66,99
38,203,251,454,348,60,232,85,83,116
38,214,223,437,342,54,228,71,67,96
38,252,271,523,379,84,296,79,60,144
38,267,274,541,398,67,262,86,91,129
38,272,318,590,449,85,331,87,94,169
38,282,283,565,415,99,330,99,76,164
38,283,264,547,396,103,316,84,76,151
38,291,266,557,421,89,313,100,86,150
38,426,435,861,474,325,486,142,126,279
38,437,466,903,665,137,436,123,118,219
38,442,446,888,496,316,481,126,142,300
38,448,455,903,675,131,438,134,129,229
38,453,516,969,735,136,471,141,155,253
38,458,443,901,489,341,507,159,143,275
38,572,561,1133,779,217,563,146,192,283
38,602,559,1161,809,210,572,203,202,283
38,602,571,1173,824,208,592,170,183,310
38,774,876,1650,1015,510,916,254,222,533
38,821,905,1726,1076,508,914,259,266,580
38,854,925,1779,1087,551,974,300,279,560
38,877,1009,1886,1436,260,1030,286,342,514
38,910,1133,2043,1595,283,1175,354,365,576
38,933,1071,2004,1496,295,1108,318,342,582
38,975,1051,2026,1583,251,1070,331,318,532
38,1007,984,1991,1502,270,1007,297,295,472
38,1052,1043,2095,1588,266,1074,334,279,513
38,1236,1218,2454,1748,386,1327,379,363,590
38,1257,1305,2562,1871,412,1404,392,390,698
38,1302,1197,2499,1659,561,1303,418,361,602
38,1328,1266,2594,1850,427,1396,442,411,646
38,1329,1230,2559,1743,572,1356,398,415,601
38,1370,1190,2560,1722,612,1353,431,387,653
38,1546,1639,3185,2355,567,1744,528,543,858
38,1549,1606,3155,2342,502,1695,523,467,898
38,1554,1685,3239,2427,492,1763,536,482,927
38,1619,1642,3261,2339,544,1675,536,525,927
38,1627,1665,3292,2460,568,1861,548,540,881
38,1653,1504,3157,2169,711,1688,454,515,788
38,1718,1594,3312,2370,684,1836,506,528,812
38,1725,1721,3446,2443,689,1848,592,600,937
38,1829,1590,3419,2295,766,1834,555,537,856
38,1832,1870,3702,2738,605,2011,607,543,1049
38,1845,1951,3796,2848,581,2076,636,568,1077
38,1901,1925,3826,2754,643,2005,635,601,1091
38,2005,1906,3911,2622,910,2164,621,583,1119
38,2079,1925,4004,2679,958,2142,619,624,1186
38,2178,2007,4185,2803,1021,2260,640,635,1228
38,8718,8159,16877,11393,3773,9688,2497,2251,4572
38,8805,8399,17204,11682,3746,9954,2710,2302,4578
38,9229,8439,17668,11932,3963,10021,2651,2573,4840
39,471,413,884,626,153,420,135,147,199
39,476,438,914,671,163,468,131,155,194
39,486,418,904,671,156,452,173,148,200
39,948,834,1782,1254,264,871,290,315,405
39,961,872,1833,1363,231,915,277,335,428
39,1012,817,1829,1309,239,868,298,311,389
39,1127,1161,2288,1648,359,1195,349,310,526
39,1183,1246,2429,1766,384,1252,361,381,599
39,1216,1183,2399,1744,379,1230,399,341,556
40,415,481,896,652,115,431,144,120,215
40,415,493,908,679,115,455,132,134,235
40,437,504,941,675,123,452,133,141,224
40,1432,1533,2965,2190,403,1496,399,419,807
40,1437,1617,3054,2299,405,1545,418,449,851
40,1458,1602,3060,2196,381,1465,410,475,725
40,1501,1517,3018,2184,435,1512,465,423,724
40,1501,1648,3149,2322,405,1603,465,484,768
40,1544,1605,3149,2264,471,1549,424,464,890
41,833,838,1671,1221,275,843,218,223,389
41,839,890,1729,1287,271,857,252,250,421
41,870,935,1805,1362,299,926,280,285,480
41,894,918,1812,1339,301,917,280,288,408
41,895,951,1846,1354,283,910,245,311,467
41,947,983,1930,1452,313,959,316,347,487
41,3148,2781,5929,3650,1643,3196,871,856,1445
41,3320,2804,6124,3856,1611,3315,968,855,1469
41,3326,2854,6180,3771,1725,3278,943,961,1479
42,413,440,853,707,73,430,126,171,209
42,415,453,868,702,79,445,134,154,220
42,433,494,927,686,142,477,129,164,236
42,458,504,962,758,101,506,147,166,243
42,474,474,948,719,145,487,159,171,234
42,494,511,1005,742,150,505,161,187,257
42,563,469,1032,698,257,549,153,165,284
42,587,468,1055,729,259,593,165,161,288
42,604,466,1070,701,291,561,157,185,277
42,694,738,1432,1118,203,701,202,274,404
42,696,824,1520,1232,106,744,239,253,373
42,713,692,1405,1087,207,715,204,253,367
42,742,822,1564,1283,108,792,229,265,370
42,753,819,1572,1296,102,755,268,278,384
42,757,762,1519,1219,181,791,233,287,426
42,844,787,1631,1193,293,831,265,307,414
42,883,774,1657,1204,314,880,268,290,394
42,925,810,1735,1274,321,910,296,308,434
42,1257,1207,2464,1816,460,1250,355,439,688
42,1317,1158,2475,1788,498,1276,361,438,644
42,1344,1230,2574,1948,440,1384,398,448,714
42,1948,1927,3875,2897,565,1938,569,670,970
42,1980,1990,3970,2911,625,2002,597,682,995
42,2077,1964,4041,3014,618,2028,556,676,1024
42,2154,2241,4395,3377,570,2106,639,787,1234
42,2210,2218,4428,3349,586,2150,599,734,1231
42,2212,2317,4529,3421,578,2170,644,802,1261
42,10964,10411,21375,14541,4826,11499,3137,3301,5795
42,11084,10446,21530,14878,4761,11790,3228,3319,5902
42,11321,10589,21910,14876,5009,11731,3175,3458,6071
43,1149,1119,2268,1701,298,1130,363,382,572
43,1150,1160,2310,1715,295,1166,282,346,589
43,1174,1167,2341,1720,278,1135,283,367,548
44,546,584,1130,824,183,569,163,208,290
44,555,560,1115,846,162,554,175,234,263
44,570,602,1172,853,201,580,200,234,276
44,1011,1105,2116,1575,283,1130,345,299,539
44,1070,1161,2231,1659,308,1239,360,286,569
44,1102,1157,2259,1622,344,1195,311,314,573
44,2288,2501,4789,3567,613,2528,680,760,1068
44,2331,2490,4821,3654,625,2694,728,735,1090
44,2416,2525,4941,3636,700,2669,753,756,1173
44,2594,2640,5234,3686,1019,2990,838,764,1329
44,2634,2597,5231,3650,1078,2973,810,799,1299
44,2814,2691,5505,3866,1127,3171,827,861,1386
44,4275,4241,8516,6788,987,4422,1298,1467,2067
44,4309,4195,8504,6553,1101,4317,1206,1421,2078
44,4697,4475,9172,7082,1287,4585,1453,1755,2358
44,19261,18475,37736,26794,7045,22625,5650,5116,9213
44,19402,18417,37819,27323,6700,22839,5660,5144,9070
44,20658,19030,39688,27947,7667,23651,5953,5660,9770
44,21855,21115,42970,30480,8064,25615,6488,5880,10542
44,22036,21014,43050,30973,7778,25812,6470,5943,10369
44,23472,21721,45193,31813,8794,26822,6780,6521,11156
45,316,288,604,429,119,317,86,114,140
45,320,313,633,454,125,334,90,119,160
45,330,321,651,459,133,341,93,126,150
45,615,661,1276,857,332,674,193,210,368
45,633,653,1286,885,328,713,182,216,368
45,640,671,1311,913,322,708,243,239,374
45,889,861,1750,1210,409,929,252,292,488
45,926,950,1876,1334,430,986,288,344,517
45,959,910,1869,1293,425,957,264,349,484
45,964,966,1930,1273,472,1075,294,294,456
45,975,944,1919,1275,466,1076,278,309,467
45,987,1011,1998,1265,579,1070,330,337,622
45,995,1017,2012,1274,610,1106,332,340,665
45,1002,983,1985,1273,558,1045,285,340,576
45,1026,963,1989,1354,493,1143,327,322,522
45,1077,1181,2258,1535,502,1301,357,330,534
45,1111,1233,2344,1618,524,1341,376,374,574
45,1165,1324,2489,1667,595,1414,422,421,643
45,1170,1348,2518,1552,708,1444,359,320,702
45,1224,1364,2588,1594,768,1476,432,366,660
45,1246,1392,2638,1695,730,1531,412,398,780
45,1287,1166,2453,1627,649,1336,402,369,738
45,1339,1201,2540,1648,681,1364,406,376,747
45,1358,1237,2595,1754,656,1450,454,402,789
45,2274,2177,4451,2892,1228,2406,732,706,1360
45,2341,2184,4525,2921,1239,2409,691,716,1323
45,2353,2254,4607,3028,1266,2556,786,742,1454
45,2543,2518,5061,3357,1312,2721,818,796,1545
45,2616,2529,5145,3397,1328,2739,778,802,1509
45,2635,2581,5216,3514,1346,2884,883,828,1638
45,7212,7164,14376,9215,3821,8220,2209,2166,3827
45,7519,7338,14857,9676,3904,8675,2426,2280,4031
45,7557,7267,14824,9548,3932,8398,2375,2362,3631
46,1325,1332,2657,1917,381,1299,376,337,703
46,1373,1395,2768,2051,378,1401,393,364,732
46,1385,1263,2648,1942,376,1338,355,304,664
47,357,408,765,477,221,409,112,104,245
47,374,396,770,467,230,402,92,114,218
47,400,401,801,480,258,455,112,95,220
47,515,577,1092,703,289,591,161,165,310
47,525,568,1093,693,283,556,165,161,298
47,580,592,1172,749,325,631,171,186,327
47,934,973,1907,1351,342,948,253,275,517
47,965,1025,1990,1412,338,1000,275,285,540
47,978,1045,2023,1489,343,1034,300,332,550
47,1363,1453,2816,2043,437,1389,403,429,731
47,1383,1467,2850,2082,421,1371,424,453,763
47,1461,1443,2904,2088,490,1415,386,443,762
47,2267,2292,4559,3162,854,2410,702,741,1174
47,2307,2205,4512,2983,967,2360,674,713,1118
47,2477,2237,4714,3116,1025,2441,679,734,1159
49,870,1068,1938,1480,249,1000,259,304,508
49,907,1056,1963,1576,213,1018,322,342,542
49,928,1084,2012,1516,281,1035,291,346,525
49,1764,1794,3558,2805,321,1660,499,608,916
49,1793,1808,3601,2868,311,1699,525,625,957
49,1794,1826,3620,2889,318,1715,548,623,956
49,2640,2957,5597,4116,874,2885,782,931,1396
49,2741,3157,5898,4359,882,3019,858,999,1418
49,2787,3031,5818,4281,931,3005,896,990,1474
49,10212,11082,21294,15121,4151,11815,3170,3440,5920
49,10465,11233,21698,15511,4060,12180,3231,3481,6106
49,10555,11078,21633,15232,4421,11987,3024,3629,6147
50,464,432,896,744,68,451,117,156,226
50,480,426,906,747,66,442,143,177,201
50,488,431,919,781,56,461,110,192,201
50,520,489,1009,848,81,499,179,203,254
50,540,465,1005,835,68,487,138,209,233
50,540,501,1041,858,96,534,165,196,263
50,1015,944,1959,1514,214,1016,303,362,441
50,1046,1038,2084,1624,215,1108,313,374,520
50,1100,956,2056,1605,213,1089,299,359,431
50,3140,3715,6855,5697,446,3413,967,1198,1756
50,3324,3962,7286,6169,416,3760,1060,1240,1914
50,3386,3746,7132,5997,473,3664,1152,1235,1873
51,786,731,1517,1273,92,773,221,218,368
51,795,709,1504,1246,87,774,224,200,337
51,813,739,1552,1285,96,768,250,219,370
51,1434,1396,2830,2219,315,1520,387,426,698
51,1448,1466,2914,2327,316,1598,442,470,729
51,1526,1419,2945,2297,344,1577,434,448,725
51,2608,2385,4993,3956,536,2674,759,846,1232
51,2706,2467,5173,4091,506,2794,842,858,1306
51,2745,2403,5148,4003,560,2710,754,856,1270
51,11114,10312,21426,15702,3491,11971,3162,3080,5535
51,11506,10620,22126,16418,3468,12646,3264,3224,5725
51,11763,10630,22393,16267,3626,12278,3361,3319,5781
52,441,395,836,582,109,414,97,137,186
52,447,404,851,614,101,421,125,128,193
52,454,437,891,636,100,436,136,132,195
52,1052,1060,2112,1643,174,1015,333,336,503
52,1076,1049,2125,1683,188,1012,313,376,507
52,1083,1011,2094,1647,204,1036,314,347,487
52,1456,1409,2865,2342,217,1411,414,405,781
52,1509,1467,2976,2485,198,1512,385,387,810
52,1512,1414,2926,2366,235,1409,433,444,777
53,2788,2757,5545,3846,1021,3022,805,922,1279
53,2843,2683,5526,3821,1055,2943,847,948,1213
53,2981,2752,5733,3877,1194,3058,851,981,1313
54,233,198,431,298,94,231,66,55,124
54,240,218,458,331,99,280,76,44,139
54,244,224,468,315,113,246,72,67,143
54,340,308,648,554,40,350,101,92,167
54,349,314,663,538,58,338,103,108,180
54,349,334,683,580,49,366,96,95,188
54,358,351,709,592,57,358,103,115,192
54,365,320,685,557,54,347,93,118,180
54,373,328,701,601,45,392,113,97,174
54,401,438,839,657,95,428,108,127,236
54,410,428,838,641,93,433,101,116,227
54,422,430,852,686,90,466,141,131,218
54,427,479,906,697,104,463,127,129,262
54,455,411,866,712,86,476,119,137,234
54,467,449,916,713,97,474,112,134,248
54,534,395,929,596,260,516,154,111,253
54,543,398,941,623,253,528,156,120,242
54,545,384,929,581,279,513,153,101,250
54,566,506,1072,782,187,589,141,168,280
54,577,467,1044,734,189,543,147,159,245
54,603,499,1102,787,204,586,187,170,281
54,723,637,1360,933,238,712,218,181,353
54,742,648,1390,949,247,741,189,189,379
54,792,649,1441,976,263,790,195,170,369
54,800,718,1518,1197,163,808,255,244,384
54,809,749,1558,1236,166,801,239,276,391
54,822,707,1529,1196,147,777,214,239,373
54,857,871,1728,1399,140,856,243,294,463
54,896,729,1625,1121,349,925,284,174,453
54,907,879,1786,1402,136,849,263,278,417
54,914,731,1645,1148,376,948,233,209,442
54,920,892,1812,1387,149,880,264,260,460
54,952,737,1689,1148,404,935,331,212,490
54,1155,1060,2215,1896,112,1115,304,367,605
54,1174,1081,2255,1889,130,1131,310,372,597
54,1189,1115,2304,1915,139,1172,331,355,628
54,1350,1181,2531,1766,430,1329,374,341,662
54,1376,1195,2571,1782,454,1397,354,332,679
54,1441,1216,2657,1829,474,1471,368,307,692
54,6502,5257,11759,8704,1604,6386,1724,1788,2859
54,6547,5379,11926,8937,1640,6673,1606,1745,2990
54,6746,5376,12122,9043,1651,6508,1755,1961,3000
54,6790,5590,12380,9291,1570,6684,1781,1886,3029
54,6837,5694,12531,9574,1608,7016,1715,1870,3131
54,7057,5738,12795,9672,1645,6833,1879,2080,3189
54,7444,6010,13454,9775,2041,7286,1977,2059,3317
54,7467,6114,13581,9993,2101,7610,1906,1976,3409
54,7749,6150,13899,10144,2157,7504,2048,2190,3437
55,836,706,1542,1187,126,729,196,187,362
55,892,718,1610,1260,143,777,218,218,369
55,931,753,1684,1320,136,843,234,230,395
55,1051,961,2012,1574,122,951,278,314,520
55,1084,970,2054,1604,117,913,260,341,529
55,1105,969,2074,1629,107,982,263,335,525
56,691,811,1502,1267,67,799,220,239,395
56,714,803,1517,1266,66,778,218,240,343
56,737,828,1565,1307,67,824,206,223,422
56,748,857,1605,1373,63,861,239,255,408
56,779,855,1634,1362,65,835,217,234,423
56,793,894,1687,1439,71,900,245,252,426
56,1127,1277,2404,1974,158,1198,343,380,560
56,1188,1257,2445,2019,167,1228,352,376,582
56,1237,1398,2635,2195,174,1352,405,440,629
56,2707,2897,5604,4356,646,2964,815,768,1405
56,2830,2874,5704,4412,627,2941,879,827,1425
56,2847,2967,5814,4565,672,3106,866,856,1474
56,3402,3432,6834,5173,776,3474,991,1032,1641
56,3556,3518,7074,5338,808,3536,1047,1064,1723
56,3767,3660,7427,5725,794,3902,1111,1143,1781
57,305,386,691,558,58,350,114,99,202
57,316,381,697,552,66,359,100,87,191
57,361,299,660,541,52,332,118,94,157
57,362,358,720,590,82,385,110,124,173
57,369,297,666,569,44,335,115,99,165
57,369,403,772,623,85,446,136,90,228
57,375,325,700,555,54,344,115,112,179
57,375,349,724,595,69,381,100,110,179
57,379,373,752,601,81,410,114,101,179
57,424,389,813,581,158,459,122,92,235
57,442,408,850,623,139,468,140,109,239
57,473,402,875,623,182,498,124,102,228
57,551,415,966,691,127,502,123,104,236
57,552,421,973,736,136,523,137,120,267
57,559,455,1014,748,140,539,155,111,289
57,636,684,1320,1016,139,650,217,240,393
57,644,671,1315,972,130,612,193,238,352
57,644,676,1320,1033,135,660,209,241,362
57,696,756,1452,1078,196,749,207,206,402
57,729,765,1494,1249,141,814,208,225,420
57,742,789,1531,1136,212,794,252,217,424
57,761,728,1489,1235,143,803,227,229,396
57,776,843,1619,1200,243,847,278,239,489
57,781,733,1514,1135,221,806,223,192,411
57,805,755,1560,1302,160,843,234,242,419
57,805,783,1588,1211,222,865,231,203,473
57,841,769,1610,1215,252,903,262,176,459
57,902,890,1792,1478,177,979,297,257,467
57,910,884,1794,1422,228,969,290,254,470
57,968,931,1899,1490,287,1064,312,284,531
57,1211,1042,2253,1786,240,1159,357,322,581
57,1247,1165,2412,1880,246,1227,349,363,657
57,1276,1054,2330,1788,305,1145,353,346,598
57,1281,1047,2328,1854,253,1201,376,345,633
57,1321,1152,2473,1934,293,1293,368,332,637
57,1332,1124,2456,1890,329,1232,394,354,661
57,1579,1511,3090,2169,614,1603,445,420,974
57,1590,1430,3020,2022,621,1517,478,390,932
57,1705,1491,3196,2181,702,1678,487,418,1033
57,1982,1951,3933,2897,604,2102,603,434,1116
57,2001,1939,3940,2971,593,2173,641,444,1109
57,2079,2078,4157,3104,659,2254,722,492,1230
57,7329,6379,13708,9434,2736,7723,2007,1701,3512
57,7497,6704,14201,10012,2701,8005,2070,1919,3854
57,7779,6675,14454,10116,2945,8218,2231,1947,3928
57,8446,7256,15702,10821,3184,8897,2315,1930,4017
57,8645,7608,16253,11455,3126,9180,2376,2158,4407
57,8914,7613,16527,11597,3371,9421,2527,2202,4480
58,384,485,869,710,68,386,108,143,231
58,408,457,865,707,65,390,120,125,234
58,424,483,907,725,54,401,129,145,236
58,1646,1494,3140,2323,451,1594,484,514,769
58,1681,1514,3195,2384,450,1663,486,523,755
58,1740,1495,3235,2349,469,1600,505,540,754
59,173,206,379,,,191,56,66,106
59,175,198,373,309,6,172,40,68,99
59,199,206,405,,,185,60,92,109
59,277,322,599,506,13,303,85,108,172
59,281,308,589,492,10,272,91,113,160
59,289,251,540,480,11,288,74,99,128
59,289,322,611,496,11,281,83,111,163
59,291,255,546,483,13,288,65,93,124
59,303,255,558,506,11,307,95,98,137
59,316,269,585,531,13,293,90,97,164
59,319,284,603,506,35,328,81,97,137
59,337,271,608,536,18,293,86,104,166
59,337,274,611,529,17,288,83,93,144
59,340,348,688,576,24,339,77,147,213
59,341,340,681,552,21,316,98,144,203
59,346,304,650,562,38,388,91,89,157
59,347,393,740,641,14,353,114,133,205
59,359,313,672,571,37,386,96,105,166
59,362,399,761,669,11,385,102,124,201
59,370,405,775,679,18,406,108,131,221
59,378,359,737,620,27,373,110,134,220
59,450,434,884,740,57,453,127,162,263
59,461,439,900,763,26,446,125,185,232
59,465,424,889,737,66,471,113,147,266
59,469,396,865,724,72,482,106,137,269
59,484,442,926,796,30,478,122,187,255
59,485,466,951,829,52,509,142,175,294
59,493,457,950,819,28,515,146,180,263
59,502,390,892,738,78,484,120,147,246
59,506,407,913,775,73,525,139,156,269
59,541,468,1009,862,52,511,157,211,233
59,541,613,1154,959,66,592,139,191,343
59,546,633,1179,977,81,582,152,203,380
59,554,473,1027,864,39,525,155,176,280
59,557,465,1022,858,35,528,142,160,275
59,574,499,1073,932,42,573,157,188,299
59,574,524,1098,933,51,565,147,211,241
59,575,475,1050,900,59,549,138,199,239
59,581,484,1065,913,50,527,141,240,244
59,583,644,1227,1036,58,636,177,196,368
59,622,570,1192,1019,62,648,177,212,291
59,627,544,1171,1015,45,613,179,188,299
59,634,647,1281,,,672,175,228,364
59,635,562,1197,1018,42,613,179,200,316
59,644,508,1152,866,159,589,158,213,341
59,645,557,1202,1036,59,660,170,210,279
59,646,459,1105,842,156,581,160,200,313
59,654,542,1196,1036,60,618,168,250,278
59,658,632,1290,,,673,195,247,378
59,658,658,1316,1133,48,668,192,253,374
59,663,568,1231,1084,45,645,194,219,327
59,667,555,1222,1069,70,663,168,256,313
59,673,554,1227,1064,66,626,179,270,281
59,680,683,1363,1188,46,718,189,262,395
59,681,498,1179,916,182,662,202,208,362
59,688,686,1374,1196,37,727,194,268,397
59,700,615,1315,1121,72,700,176,227,337
59,707,692,1399,1237,38,754,214,289,402
59,722,652,1374,,,664,185,266,353
59,727,616,1343,1208,25,680,195,257,345
59,735,587,1322,1062,69,673,186,215,310
59,750,690,1440,1243,37,734,199,284,360
59,751,617,1368,,,683,188,269,342
59,770,616,1386,1127,77,746,198,233,333
59,775,697,1472,1279,43,766,187,280,379
59,778,749,1527,1183,135,810,223,232,480
59,779,751,1530,1322,78,848,217,242,445
59,782,557,1339,1119,68,698,158,223,346
59,785,687,1472,1168,158,862,204,210,389
59,796,574,1370,1169,62,712,226,236,364
59,796,712,1508,1325,39,822,241,278,400
59,796,784,1580,1378,82,853,183,273,467
59,802,685,1487,1153,161,841,185,230,371
59,807,727,1534,1242,133,849,225,249,453
59,808,768,1576,1340,90,846,209,256,432
59,808,796,1604,1291,137,879,218,260,529
59,810,628,1438,1222,86,740,193,256,419
59,840,844,1684,1515,39,850,226,328,457
59,841,847,1688,1446,59,870,256,275,459
59,849,741,1590,1282,158,933,223,243,424
59,863,853,1716,1525,49,876,236,335,481
59,868,793,1661,1442,73,830,233,337,395
59,868,851,1719,1543,31,865,247,355,480
59,887,801,1688,1477,73,847,227,335,380
59,893,889,1782,1539,60,945,263,289,485
59,913,933,1846,1577,53,904,233,360,515
59,914,817,1731,1504,67,879,228,310,473
59,921,815,1736,1508,74,852,248,363,409
59,928,856,1784,1566,60,914,222,330,494
59,938,972,1910,1700,32,1021,252,376,531
59,942,906,1848,1666,46,984,265,330,547
59,988,1033,2021,1661,46,983,291,321,467
59,992,922,1914,1706,35,1001,286,399,497
59,1005,993,1998,1804,42,1049,305,440,549
59,1007,929,1936,1620,47,921,275,345,591
59,1010,1074,2084,1713,47,966,290,363,478
59,1013,972,1985,1626,39,924,259,343,605
59,1027,1032,2059,1746,53,994,322,372,482
59,1084,1000,2084,1770,143,1107,315,421,641
59,1089,1070,2159,1674,174,1156,275,261,539
59,1095,972,2067,1801,44,1044,297,367,646
59,1098,1128,2226,1808,193,1239,335,286,595
59,1103,1000,2103,1733,152,1113,327,399,625
59,1120,1107,2227,1653,201,1141,300,262,556
59,1128,1002,2130,1601,310,1222,278,275,543
59,1135,979,2114,1729,142,1091,272,393,627
59,1141,1280,2421,2109,52,1172,345,466,637
59,1147,1019,2166,1674,312,1273,317,283,591
59,1149,1170,2319,2055,48,1260,347,387,730
59,1166,1140,2306,2012,44,1240,311,368,682
59,1174,1080,2254,1647,361,1309,331,276,586
59,1182,1082,2264,1943,82,1169,301,387,671
59,1182,1172,2354,2093,51,1269,297,412,706
59,1194,1107,2301,1970,114,1170,297,465,621
59,1210,1104,2314,1997,105,1210,317,435,695
59,1211,1112,2323,2022,84,1220,342,412,729
59,1214,1186,2400,2095,114,1272,370,480,665
59,1218,1296,2514,2201,65,1270,341,498,639
59,1225,1144,2369,1984,138,1197,327,434,709
59,1244,1289,2533,2202,49,1256,334,457,665
59,1270,1213,2483,,,,,,
59,1271,1185,2456,,,1277,328,437,
59,1275,1153,2428,2064,135,1274,328,417,715
59,1288,1170,2458,2182,106,1273,394,529,648
59,1295,1248,2543,,,1302,370,520,723
59,1295,1315,2610,1952,363,1464,387,387,717
59,1297,1254,2551,,,1364,368,447,
59,1298,1234,2532,,,1292,344,502,722
59,1298,1255,2553,,,1369,400,511,737
59,1304,1199,2503,2173,136,1319,402,464,801
59,1336,1358,2694,1993,349,1493,423,405,731
59,1397,1391,2788,2133,375,1597,382,438,760
59,1530,1600,3130,2486,227,1681,451,338,837
59,1564,1658,3222,2642,237,1794,468,401,882
59,1566,1484,3050,2421,266,1695,444,513,754
59,1606,1642,3248,2577,240,1745,443,366,841
59,1613,1520,3133,2592,279,1796,506,566,826
59,1662,1515,3177,2510,296,1755,489,561,800
59,1668,1522,3190,2499,344,1774,417,530,913
59,1688,1520,3208,2560,326,1811,463,528,900
59,1773,1622,3395,2685,358,1970,510,527,960
59,2110,1938,4048,3509,142,2083,523,717,1165
59,2124,1921,4045,3501,172,2089,545,745,1168
59,2153,2018,4171,3688,130,2204,607,742,1276
59,2276,2152,4428,3751,200,2193,606,733,1202
59,2363,2108,4471,3866,186,2213,616,786,1209
59,2422,2252,4674,4057,214,2379,731,797,1271
59,2508,2531,5039,4052,449,2628,706,755,1341
59,2516,2469,4985,4025,403,2552,676,782,1293
59,2600,2695,5295,4341,414,2731,759,875,1457
59,2605,2198,4803,3553,556,2453,675,762,1415
59,2682,2198,4880,3719,572,2559,669,778,1462
59,2697,2286,4983,3874,601,2717,749,810,1565
59,3084,2660,5744,4851,400,3036,763,1077,1719
59,3103,2620,5723,4796,369,3076,818,1043,1672
59,3118,2628,5746,4773,379,3016,839,1052,1656
59,3175,2679,5854,4881,409,3170,821,996,1715
59,3200,2761,5961,5041,436,3171,757,1088,1791
59,3238,2710,5948,4917,432,3135,854,1040,1691
59,3305,2819,6124,5064,461,3243,815,1098,1553
59,3312,3223,6535,4700,1050,3594,890,842,1684
59,3324,3224,6548,4802,1055,3705,896,829,1775
59,3348,2891,6239,5140,493,3302,858,1167,1613
59,3397,2919,6316,5380,450,3448,975,1232,1651
59,3401,2923,6324,4963,622,3322,904,1074,1698
59,3425,3399,6824,5123,1088,3955,1008,903,1906
59,3580,2983,6563,5295,602,3597,975,1127,1795
59,3612,3125,6737,5607,483,3552,893,1224,1695
59,3624,2980,6604,5254,678,3525,925,1139,1775
59,3682,3149,6831,5674,485,3598,919,1238,1706
59,3696,3210,6906,5723,514,3638,953,1298,1755
59,3725,3244,6969,5952,471,3789,1079,1351,1814
59,3735,3219,6954,5769,516,3678,950,1307,1780
59,3805,3269,7074,6033,480,3833,1082,1385,1827
59,3890,3454,7344,5796,698,3867,1053,1228,1987
59,3959,3361,7320,6100,521,3861,983,1348,1831
59,4021,3445,7466,6204,559,3928,1037,1437,1894
59,4064,3474,7538,6449,520,4111,1143,1488,1964
59,4118,3536,7654,6127,764,4113,1076,1296,2118
59,4120,3580,7700,6234,707,4198,1134,1327,2158
59,4563,3886,8449,,,4321,1198,1421,2483
59,4686,3947,8633,,,4496,1174,1445,
59,4769,4072,8841,7110,924,4780,1372,1516,2778
59,5153,4468,9621,8070,635,5031,1280,1813,2452
59,5235,4631,9866,8299,673,5200,1407,1917,2559
59,5352,4644,9996,8631,626,5384,1537,2017,2612
59,5876,5594,11470,9361,762,5962,1550,1849,3168
59,6075,5633,11708,9670,794,6058,1674,1988,3197
59,6150,5659,11809,9801,713,6254,1676,1944,3227
59,6638,5885,12523,10254,949,6544,1778,2224,3531
59,6816,6080,12896,10825,907,6962,1939,2311,3785
59,6869,5926,12795,10479,1022,6724,1738,2266,3617
59,6994,6821,13815,10669,1908,7713,1967,1928,3969
59,7251,7083,14334,11080,1984,8010,2123,2077,4146
59,7514,7173,14687,11497,1987,8250,2170,2241,4285
59,9144,7081,16225,10936,3773,9025,2359,2189,4399
59,9438,7296,16734,11127,3838,9147,2448,2247,4393
59,9502,9352,18854,14721,2357,10341,2673,2683,5310
59,9701,7493,17194,11863,3942,9850,2675,2363,4895
59,9767,9552,19319,15105,2387,10562,2799,2859,5439
59,10114,9868,19982,15838,2401,10981,2929,3116,5742
59,10790,8779,19569,13656,4016,10704,2840,2702,5285
59,11150,8987,20137,13893,4096,10921,2900,2733,5262
59,11534,9305,20839,14898,4192,11724,3188,2943,5864
59,16508,14098,30606,21635,5511,17768,4206,4217,7979
59,17134,14487,31621,22021,5804,17954,4403,4536,8169
59,17190,14737,31927,23162,5624,18975,4700,4514,8452
59,18839,16445,35284,25202,6035,20319,4904,4893,9206
59,19470,16825,36295,25609,6350,20555,5076,5196,9421
59,19623,17157,36780,27002,6169,21740,5377,5246,9763
59,19720,17557,37277,27422,6297,20524,5346,5170,10325
59,20329,17941,38270,27947,6404,20836,5534,5393,10411
59,20944,18477,39421,29523,6519,22022,5939,5786,11213
59,21177,18613,39790,28394,6986,22968,5475,5415,10457
59,21822,18982,40804,28673,7272,23053,5690,5734,10521
59,22012,19486,41498,30375,7125,24501,6103,5795,11099
60,285,330,615,490,50,349,73,96,157
60,302,362,664,547,59,384,103,113,188
60,310,329,639,531,50,376,114,103,187
60,325,364,689,515,104,400,99,97,198
60,345,366,711,517,125,411,108,100,204
60,364,366,730,544,131,437,100,102,229
60,470,492,962,790,66,513,160,183,245
60,494,491,985,809,69,506,158,196,253
60,515,504,1019,826,69,508,153,204,238
60,603,654,1257,1044,127,688,198,208,308
60,632,653,1285,1060,124,678,204,226,315
60,647,674,1321,1073,156,714,191,225,321
60,670,723,1393,1109,174,758,190,233,415
60,700,753,1453,1157,187,787,233,252,438
60,701,718,1419,1173,160,784,233,240,434
60,798,903,1701,1199,314,856,256,287,502
60,855,959,1814,1276,331,925,279,292,534
60,863,933,1796,1252,339,924,288,297,531
60,968,929,1897,1403,295,1021,271,278,540
60,975,926,1901,1405,293,1045,272,272,518
60,1005,849,1854,1237,461,1027,298,267,522
60,1026,885,1911,1295,481,1098,314,287,571
60,1028,1008,2036,1501,320,1110,309,310,570
60,1030,831,1861,1263,450,1013,285,300,524
60,1323,1269,2592,1560,799,1481,412,383,762
60,1341,1227,2568,1592,782,1512,420,355,762
60,1410,1329,2739,1579,873,1565,420,391,801
60,2218,2162,4380,3054,838,2423,649,584,1133
60,2308,2277,4585,3310,824,2612,702,616,1238
60,2386,2239,4625,3240,864,2523,698,639,1204
60,2411,2013,4424,2667,1383,2607,696,628,1271
60,2551,2106,4657,2767,1449,2713,739,612,1292
60,2604,2194,4798,2930,1527,2890,834,688,1405
60,3664,3787,7451,5329,1368,3985,1096,1206,2181
60,3748,3826,7574,5446,1415,4072,1204,1242,2184
60,3777,3914,7691,5599,1360,4192,1144,1262,2214
61,441,468,909,695,133,487,142,150,258
61,449,450,899,687,117,456,130,152,236
61,460,430,890,683,116,470,160,138,222
61,772,708,1480,1188,122,771,231,230,345
61,796,739,1535,1255,114,804,269,258,378
61,799,654,1453,1160,123,730,224,233,344
61,1042,968,2010,1517,289,1026,286,366,512
61,1059,954,2013,1471,266,983,291,352,473
61,1067,949,2016,1524,270,1018,305,354,518
61,1628,1509,3137,2305,441,1589,479,539,827
61,1630,1528,3158,2304,443,1586,488,540,842
61,1665,1604,3269,2443,421,1670,551,555,910
62,218,266,484,415,6,228,56,98,112
62,225,230,455,,,227,73,78,107
62,229,270,499,,,254,59,95,124
62,232,226,458,402,9,235,64,75,112
62,233,241,474,,,239,65,87,119
62,240,273,513,448,5,266,52,87,127
62,318,333,651,578,5,319,90,123,163
62,327,349,676,586,5,318,95,137,157
62,338,333,671,,,318,102,135,174
62,348,404,752,635,37,388,96,118,190
62,363,422,785,661,37,406,108,134,217
62,364,429,793,672,35,409,110,123,210
62,432,532,964,856,9,505,138,165,254
62,454,462,916,790,29,499,125,148,211
62,459,565,1024,,,517,151,183,277
62,471,523,994,895,11,525,142,180,239
62,489,450,939,857,7,491,154,192,235
62,491,482,973,860,23,561,157,159,243
62,492,459,951,812,28,497,143,158,204
62,501,479,980,896,9,526,133,208,254
62,509,460,969,868,11,504,157,196,240
62,518,552,1070,942,26,530,135,202,246
62,535,459,994,860,58,526,128,161,250
62,538,569,1107,1000,14,590,156,190,323
62,549,525,1074,946,17,574,149,206,252
62,554,516,1070,934,25,572,151,188,258
62,557,606,1163,983,51,597,147,192,302
62,558,536,1094,993,15,574,147,232,273
62,561,563,1124,,,556,145,238,273
62,562,542,1104,971,32,542,140,207,250
62,571,608,1179,989,53,610,166,185,312
62,573,496,1069,952,25,600,147,194,256
62,573,573,1146,,,614,188,182,285
62,573,574,1147,,,606,167,187,283
62,576,549,1125,1015,29,608,155,205,261
62,580,559,1139,973,13,544,155,233,270
62,580,576,1156,1010,15,584,178,223,298
62,589,480,1069,944,59,595,142,182,265
62,591,447,1038,896,59,550,138,169,264
62,597,608,1205,1087,16,644,143,208,329
62,606,585,1191,990,22,542,146,237,258
62,614,586,1200,1021,15,565,185,244,268
62,614,591,1205,,,622,195,213,304
62,624,645,1269,1116,20,658,159,222,286
62,627,642,1269,1087,51,685,168,203,332
62,627,647,1274,,,677,182,223,299
62,649,659,1308,1167,11,639,209,255,342
62,651,626,1277,1097,11,620,175,277,329
62,659,589,1248,1069,14,619,181,248,304
62,669,594,1263,1142,14,657,205,240,316
62,673,674,1347,1221,14,707,200,267,351
62,674,674,1348,,,714,214,256,267
62,675,656,1331,1174,10,685,205,232,339
62,679,577,1256,1107,16,631,177,278,324
62,680,681,1361,1179,14,623,197,271,341
62,680,687,1367,,,715,203,289,360
62,688,651,1339,,,702,165,258,339
62,699,802,1501,,,780,184,285,398
62,702,632,1334,1147,22,614,151,281,318
62,724,670,1394,1241,18,750,199,242,367
62,727,705,1432,1260,16,678,267,276,384
62,734,804,1538,1378,19,799,209,270,416
62,747,794,1541,1340,11,776,215,254,357
62,764,816,1580,1372,10,775,208,282,378
62,768,875,1643,1463,15,835,246,332,443
62,776,726,1502,1314,50,798,236,299,353
62,779,707,1486,1322,42,786,227,312,339
62,779,800,1579,1432,14,825,222,354,418
62,781,767,1548,,,753,216,327,391
62,783,730,1513,,,749,220,294,367
62,784,775,1559,,,813,221,344,390
62,788,780,1568,,,748,206,336,406
62,790,808,1598,,,855,237,283,425
62,791,748,1539,,,746,216,309,385
62,803,721,1524,1347,20,785,214,303,356
62,808,718,1526,1344,46,793,218,304,343
62,808,721,1529,,,766,215,331,398
62,816,846,1662,,,886,246,362,448
62,821,711,1532,1338,19,788,217,307,348
62,826,742,1568,,,788,218,333,410
62,841,852,1693,1507,43,923,270,345,448
62,848,825,1673,1458,59,926,226,307,421
62,864,710,1574,1383,12,795,233,322,340
62,866,828,1694,1488,53,918,246,336,420
62,920,902,1822,1590,56,967,264,288,446
62,952,927,1879,1650,55,1003,265,310,491
62,1023,941,1964,1764,59,1097,308,331,498
62,1076,1058,2134,1902,58,1171,291,385,582
62,1100,1018,2118,1892,59,1131,298,447,526
62,1109,1103,2212,1980,47,1226,293,400,598
62,1163,968,2131,1814,109,1073,306,419,498
62,1181,942,2123,1817,117,1070,289,415,461
62,1202,993,2195,1856,116,1139,320,413,515
62,1212,960,2172,1805,127,1097,304,414,516
62,1216,1101,2317,2116,29,1229,375,469,575
62,1217,1124,2341,2093,62,1203,312,489,585
62,1218,1192,2410,2152,35,1264,341,498,606
62,1220,958,2178,1819,147,1107,309,443,525
62,1232,1120,2352,2082,63,1218,318,433,619
62,1237,1144,2381,2114,33,1229,375,477,617
62,1290,1038,2328,1939,126,1167,341,487,587
62,1300,1204,2504,2245,60,1316,333,478,655
62,1345,1300,2645,,,1333,343,551,686
62,1351,1282,2633,2332,26,1323,396,521,652
62,1385,1141,2526,2181,134,1296,342,510,619
62,1398,1118,2516,2147,128,1287,358,480,598
62,1421,1324,2745,,,1416,387,598,733
62,1422,1182,2604,2245,127,1367,380,522,636
62,1448,1419,2867,2521,91,1500,385,549,676
62,1479,1373,2852,2571,41,1465,383,588,775
62,1485,1414,2899,2535,93,1506,386,555,688
62,1527,1376,2903,2590,39,1443,397,622,741
62,1543,1454,2997,2664,97,1604,438,577,744
62,1553,1436,2989,2756,46,1625,458,620,845
62,1589,1528,3117,2550,151,1583,436,545,836
62,1683,1583,3266,2809,130,1716,475,663,782
62,1687,1598,3285,2821,129,1714,494,667,811
62,1694,1472,3166,2582,181,1629,430,558,837
62,1708,1573,3281,2803,155,1744,520,591,902
62,1728,1684,3412,,,1734,480,590,915
62,1763,1660,3423,3090,47,1772,466,711,930
62,1799,1601,3400,2973,128,1814,506,690,855
62,1823,1724,3547,3265,53,1931,539,733,995
62,1826,1659,3485,3098,47,1750,475,733,883
62,1830,1643,3473,,,1785,471,614,923
62,1867,1535,3402,2879,188,1732,502,656,800
62,1879,1745,3624,,,1931,575,643,989
62,1907,1495,3402,2898,204,1737,466,668,768
62,1912,1805,3717,3356,48,1911,514,789,1009
62,1921,1579,3500,2943,199,1834,510,665,825
62,1971,1792,3763,,,1901,513,813,954
62,2012,1889,3901,3578,56,2115,591,821,1081
62,2104,1762,3866,3383,127,2011,480,779,931
62,2114,1731,3845,3385,132,2014,580,767,929
62,2131,1729,3860,3348,116,1991,513,744,928
62,2222,2062,4284,3655,212,2176,595,848,1080
62,2225,2075,4300,3639,187,2191,576,785,1063
62,2289,2104,4393,3799,186,2325,630,889,1045
62,2300,2134,4434,3829,175,2333,649,903,1087
62,2404,2242,4646,3927,205,2371,672,888,1216
62,2437,2149,4586,4008,184,2469,669,909,1159
62,2449,1861,4310,3640,256,2230,669,857,1049
62,2499,1938,4437,3769,302,2336,643,876,1084
62,2533,1975,4508,3858,285,2376,636,929,1155
62,2596,2011,4607,3904,268,2395,722,913,1138
62,2626,2077,4703,3995,314,2471,682,917,1147
62,2678,2124,4802,4114,294,2536,688,983,1231
62,2949,2519,5468,4179,588,2961,747,823,1318
62,3036,2520,5556,4297,581,2985,748,876,1334
62,3134,2687,5821,4932,248,2932,825,1139,1438
62,3150,2590,5740,4859,280,2912,884,1142,1401
62,3150,2801,5951,4977,237,2993,872,1098,1481
62,3159,2656,5815,4524,582,3204,845,865,1443
62,3234,2654,5888,5037,327,3073,867,1150,1406
62,3246,2913,6159,5288,219,3219,929,1134,1616
62,3264,2719,5983,5151,310,3098,835,1242,1489
62,3313,2948,6261,4851,623,3370,857,946,1528
62,3384,2924,6308,4932,618,3373,844,994,1524
62,3522,3078,6600,5185,619,3610,953,999,1660
62,3763,3443,7206,6055,258,3568,1043,1336,1788
62,3778,3349,7127,6049,273,3566,990,1367,1763
62,3783,3346,7129,6099,259,3571,1034,1394,1780
62,3830,3482,7312,6156,251,3616,1069,1369,1822
62,3882,3580,7462,6404,244,3825,1120,1367,1960
62,3973,3618,7591,6548,235,3897,1196,1410,2000
62,4935,3917,8852,7575,382,4543,1288,1742,2132
62,4959,4015,8974,7728,436,4665,1223,1785,2167
62,5030,4035,9065,7853,423,4707,1325,1850,2232
62,5519,4820,10339,8824,321,5108,1504,1969,2649
62,5530,4778,10308,8875,337,5157,1381,1956,2624
62,5700,4908,10608,9111,295,5302,1445,1995,2806
63,698,907,1605,1363,93,879,243,239,425
63,742,926,1668,1408,102,912,238,240,453
63,769,922,1691,1436,108,919,269,236,470
63,832,818,1650,1289,164,802,214,255,445
63,835,812,1647,1281,176,798,252,255,454
63,851,822,1673,1282,170,777,199,269,424
63,7970,7586,15556,11076,3057,8773,2328,2453,3990
63,8185,7907,16092,11637,2926,9084,2328,2561,4195
63,8300,7846,16146,11542,3184,8900,2314,2783,4280
64,3012,3206,6218,4624,741,3339,894,798,1465
64,3091,3198,6289,4816,749,3484,966,883,1516
64,3159,3307,6466,4814,745,3366,1006,878,1614
64,4166,4364,8530,6070,1397,4416,1279,1160,2111
64,4304,4271,8575,6093,1429,4473,1201,1183,2161
64,4346,4539,8885,6512,1427,4686,1336,1284,2271
65,1307,1371,2678,1809,655,1247,282,259,986
65,1357,1411,2768,1898,726,1366,239,313,1054
65,1375,1429,2804,1851,763,1347,221,331,1053
65,2860,2865,5725,4296,763,2867,847,827,1627
65,2932,3034,5966,4495,759,2980,902,904,1746
65,2972,2875,5847,4360,802,2871,891,958,1635
65,3098,3153,6251,4736,798,3129,913,903,1773
65,3174,3311,6485,4936,786,3233,977,980,1889
65,3198,3173,6371,4786,827,3106,963,1031,1781
66,763,791,1554,1126,319,804,171,226,464
66,765,762,1527,1092,290,795,187,239,498
66,768,786,1554,1104,333,786,203,273,490
66,9450,8135,17585,12654,3221,9270,2520,2458,5068
66,9509,8292,17801,12742,3390,9228,2531,2519,5119
66,9605,8335,17940,13074,3002,9502,2650,2463,5211
67,641,615,1256,883,220,653,165,185,328
67,653,609,1262,879,218,638,191,195,318
67,661,703,1364,1014,269,742,194,240,396
67,693,588,1281,876,221,608,208,206,307
67,700,715,1415,1032,275,766,220,246,394
67,702,727,1429,1065,286,786,217,289,394
67,931,990,1921,1403,358,1122,339,289,542
67,1023,980,2003,1425,376,1143,324,289,532
67,1089,1101,2190,1664,328,1215,338,300,598
67,1107,1094,2201,1546,442,1264,371,288,618
67,1119,1163,2282,1758,336,1318,375,335,648
67,1136,1027,2163,1506,479,1200,315,294,595
67,1191,1154,2345,1787,345,1264,366,348,651
67,1199,992,2191,1519,487,1238,354,305,571
67,1238,1047,2285,1590,506,1254,350,334,634
67,1617,1657,3274,2616,410,1802,530,536,858
67,1664,1681,3345,2564,444,1731,517,566,849
67,1795,1739,3534,2735,452,1835,593,603,903
67,2246,2030,4276,2941,974,2481,685,584,1184
67,2249,1959,4208,2812,1011,2426,704,532,1132
67,2355,2027,4382,2928,1087,2519,729,587,1225
67,3385,2986,6371,4318,1490,3626,1019,826,1727
67,3445,3022,6467,4460,1461,3719,1039,889,1755
67,3593,3074,6667,4518,1593,3773,1079,921,1859
67,17582,15299,32881,21709,7981,19018,4928,4187,8622
67,17928,15663,33591,22551,8071,19784,5137,4357,9110
67,18600,16083,34683,22860,8623,19999,5428,4626,9634
68,543,522,1065,867,123,573,173,172,266
68,563,528,1091,873,124,574,148,181,285
68,595,551,1146,937,119,600,159,176,317
68,694,683,1377,1111,140,734,223,201,377
68,753,680,1433,1167,138,773,247,215,382
68,757,737,1494,1222,157,810,251,249,444
68,1322,1052,2374,1558,668,1357,358,286,649
68,1357,1103,2460,1559,762,1443,405,295,718
68,1518,1214,2732,1747,839,1572,481,340,815
68,3631,3376,7007,5015,1365,3856,1040,962,1829
68,3733,3505,7238,5243,1359,4038,1183,1024,1888
68,3960,3538,7498,5339,1467,4096,1221,1062,2087
68,9232,7008,16240,10307,4548,9124,2491,2222,4411
68,9324,6998,16322,10546,4434,9341,2600,2189,4401
68,9680,7175,16855,10645,4781,9346,2637,2302,4631
68,10047,7761,17808,11507,4786,9968,2750,2476,4839
68,10148,7785,17933,11785,4675,10253,2852,2411,4860
68,10574,7997,18571,11949,5046,10266,2942,2562,5109
69,340,342,682,490,112,351,100,102,193
69,346,325,671,487,110,339,97,83,174
69,359,331,690,505,96,342,110,94,186
69,413,437,850,683,89,461,150,124,217
69,415,451,866,698,90,469,162,141,223
69,416,504,920,682,134,466,123,167,245
69,455,494,949,709,131,497,142,134,244
69,455,517,972,733,120,520,133,149,264
69,482,478,960,776,93,510,168,152,240
69,483,484,967,733,127,487,138,168,244
69,578,732,1310,970,178,664,218,206,341
69,603,548,1151,885,154,561,211,189,277
69,609,599,1208,927,148,576,195,206,323
69,629,560,1189,903,158,584,163,193,269
69,646,517,1163,821,242,660,182,177,291
69,656,538,1194,870,220,681,202,195,316
69,664,765,1429,1085,189,712,233,244,360
69,674,540,1214,861,254,682,206,196,294
69,733,825,1558,1203,186,843,244,209,426
69,743,814,1557,1242,172,829,254,211,440
69,771,836,1607,1257,165,813,263,231,447
69,1379,1209,2588,1499,834,1532,402,337,696
69,1390,1539,2929,2224,471,1630,497,436,852
69,1420,1250,2670,1781,600,1377,447,407,722
69,1426,1263,2689,1770,639,1385,406,408,741
69,1431,1259,2690,1810,589,1438,414,401,730
69,1431,1541,2972,2259,442,1627,480,463,822
69,1469,1241,2710,1647,835,1632,475,371,716
69,1477,1610,3087,2357,443,1657,514,502,841
69,1485,1519,3004,2286,473,1605,470,492,876
69,1491,1630,3121,2374,479,1696,500,490,854
69,1497,1258,2755,1549,940,1618,478,343,752
69,1534,1733,3267,2538,459,1760,549,542,992
69,1679,1705,3384,2499,594,1983,575,457,848
69,1690,1685,3375,2502,603,1995,536,460,882
69,1728,1742,3470,2562,599,2015,561,490,946
69,1745,1566,3311,2252,758,1808,532,478,899
69,1774,1625,3399,2325,787,1909,578,503,920
69,1817,1653,3470,2326,808,1924,574,463,986
69,2238,1964,4202,2807,967,2316,633,594,1101
69,2346,1962,4308,2924,965,2381,683,623,1100
69,2401,2035,4436,2968,1025,2415,691,643,1181
69,2430,2111,4541,3114,931,2458,737,680,1170
69,2437,2193,4630,3157,928,2519,720,668,1154
69,2445,2200,4645,3179,959,2522,726,712,1282
69,2492,2592,5084,3522,1002,2843,774,712,1434
69,2551,2529,5080,3641,936,2855,848,775,1381
69,2626,2672,5298,3671,1085,2956,872,769,1543
69,2898,2618,5516,3838,1056,2939,884,817,1409
69,2910,2692,5602,3891,1051,3021,877,809,1391
69,2962,2724,5686,3975,1085,3043,914,865,1560
69,3568,3121,6689,4352,1757,3758,1135,994,1851
69,3738,3205,6943,4468,1882,3962,1135,983,2013
69,3769,3269,7038,4559,1857,3994,1118,1034,1975
69,5033,4150,9183,6028,2494,5403,1519,1335,2585
69,5159,4234,9393,6106,2537,5512,1531,1390,2540
69,5300,4331,9631,6330,2638,5604,1555,1473,2759
69,5806,5085,10891,7159,2724,6074,1768,1588,2952
69,6115,5231,11346,7483,2822,6375,1801,1657,3075
69,6139,5240,11379,7436,2907,6377,1826,1626,3194
69,6412,5359,11771,7527,3328,6935,1921,1672,3281
69,6628,5475,12103,7753,3372,7144,2006,1761,3256
69,6797,5589,12386,7879,3578,7222,2033,1816,3511
69,9125,8607,17732,12146,3769,10142,2750,2499,4615
69,9328,8754,18082,12611,3744,10545,2824,2522,4765
69,9786,9283,19069,13187,4049,10969,3078,2812,5374
69,26910,26294,53204,39182,8625,31540,8025,6963,13939
69,27312,26635,53947,40053,8738,32518,8517,7129,14124
69,29208,27819,57027,41896,9546,33365,8855,8076,15564
69,31943,30444,62387,45210,11119,36943,9544,8298,16524
69,32471,30869,63340,46159,11275,38030,10048,8519,16664
69,34508,32150,66658,48226,12184,38969,10410,9549,18323
70,338,320,658,530,44,304,121,125,164
70,347,324,671,534,53,308,114,125,145
70,364,340,704,541,55,302,105,131,172
70,394,387,781,636,60,407,141,102,220
70,431,408,839,681,69,408,146,140,225
70,445,391,836,685,50,417,121,137,224
70,514,492,1006,760,125,531,151,153,256
70,536,505,1041,814,108,511,170,190,268
70,537,610,1147,974,68,589,194,196,310
70,556,532,1088,847,113,546,187,190,279
70,588,581,1169,963,66,594,164,182,284
70,649,621,1270,1054,68,651,202,195,332
70,948,890,1838,1424,222,964,253,291,468
70,974,820,1794,1371,227,940,275,264,411
70,1003,860,1863,1405,263,962,293,310,441
71,159,142,301,243,27,137,47,50,79
71,159,147,306,253,32,154,46,52,77
71,164,135,299,237,35,152,46,48,69
71,704,749,1453,1139,176,691,190,238,359
71,709,723,1432,1156,166,715,216,231,372
71,731,766,1497,1202,176,724,225,252,366
71,1038,1022,2060,1648,207,1022,311,325,540
71,1043,962,2005,1607,213,1035,292,309,498
71,1072,948,2020,1651,207,1069,291,314,493
71,1148,1208,2356,1864,273,1189,352,362,595
71,1170,1177,2347,1888,246,1168,399,369,591
71,1228,1157,2385,1888,288,1161,353,397,586
71,2359,2226,4585,3225,1002,2568,759,769,1146
71,2404,2225,4629,3151,1103,2547,782,745,1132
71,2479,2284,4763,3241,1162,2581,770,810,1154
71,2749,2738,5487,4021,949,3001,788,773,1379
71,2796,2752,5548,4116,940,3062,834,779,1443
71,2911,2789,5700,4199,1035,3151,893,819,1470
72,651,763,1414,1027,252,749,214,246,402
72,678,759,1437,1065,246,746,210,263,407
72,689,730,1419,1043,253,740,193,264,424
72,774,844,1618,1161,319,858,229,335,369
72,779,858,1637,1188,301,891,234,312,351
72,802,795,1597,1143,323,855,248,314,357
72,9613,10155,19768,14208,3520,10656,2733,3341,5450
72,9705,10230,19935,14522,3406,10884,2868,3310,5506
72,9755,10343,20098,14468,3469,10640,2896,3370,5710
72,10099,10780,20879,14986,3760,11233,2900,3560,5806
72,10198,10858,21056,15323,3625,11500,3038,3501,5858
72,10260,10971,21231,15275,3709,11230,3062,3583,6077
73,858,898,1756,1161,423,924,293,248,414
73,874,892,1766,1190,409,943,263,250,390
73,995,957,1952,1327,475,1024,398,304,517
73,1475,1593,3068,2318,396,1591,443,425,805
73,1518,1598,3116,2279,467,1576,479,412,813
73,1701,1656,3357,2458,494,1713,514,444,921
73,3296,2813,6109,4034,1223,3283,910,769,1423
73,3298,2923,6221,4229,1197,3384,910,856,1527
73,3550,2986,6536,4403,1345,3551,1054,909,1589
74,537,667,1204,896,198,644,181,183,331
74,584,662,1246,931,199,699,224,173,336
74,650,658,1308,932,286,820,238,138,446
74,665,620,1285,862,356,777,251,108,445
74,667,679,1346,951,318,849,275,163,476
74,700,711,1411,1019,233,782,234,191,343
74,729,570,1299,858,345,766,217,100,398
74,789,767,1556,1123,346,1022,305,163,563
74,867,653,1520,996,449,920,339,135,462
74,1064,1164,2228,1443,561,1176,368,335,571
74,1107,1113,2220,1427,570,1180,372,334,559
74,1258,1189,2447,1545,613,1278,409,362,612
74,1883,1831,3714,2761,585,2093,613,481,1014
74,1936,1858,3794,2775,628,2037,668,530,1039
74,2205,2049,4254,3162,692,2342,768,554,1214
74,2273,2112,4385,2845,1164,2756,794,461,1379
74,2402,2141,4543,3038,1231,2853,791,512,1431
74,2832,2475,5307,3461,1484,3372,1077,608,1734
75,110038,106838,216876,153168,44853,123353,31665,17049,61664
75,111806,108291,220097,156067,46614,127247,32838,17456,62595
75,119287,114618,233905,163635,49585,131309,34397,21056,69824
76,361,371,732,597,55,364,107,126,182
76,366,369,735,593,68,365,105,127,176
76,388,392,780,636,71,378,129,147,188
76,545,656,1201,1043,25,599,180,236,275
76,552,611,1163,1016,22,572,183,216,271
76,586,654,1240,968,146,666,194,210,345
76,596,588,1184,916,168,653,168,195,317
76,600,612,1212,936,168,635,170,200,340
76,603,620,1223,1110,37,618,168,290,290
76,603,629,1232,966,156,655,189,211,342
76,606,559,1165,906,171,658,180,187,292
76,606,620,1226,964,164,666,179,207,326
76,630,677,1307,1142,25,644,209,256,302
76,633,625,1258,1121,46,634,192,285,297
76,635,623,1258,1148,45,639,184,307,339
76,730,675,1405,1118,152,769,214,230,394
76,730,691,1421,1155,162,774,176,253,382
76,738,767,1505,1175,215,813,233,274,409
76,750,805,1555,1220,201,827,224,281,407
76,762,685,1447,1148,164,798,228,229,393
76,777,802,1579,1211,204,810,233,288,438
76,778,822,1600,1297,153,851,223,294,442
76,785,818,1603,1332,146,871,230,295,451
76,856,799,1655,1373,161,910,275,308,411
76,1021,973,1994,1470,380,1044,320,408,550
76,1026,902,1928,1406,349,995,281,370,483
76,1047,933,1980,1436,376,1029,272,392,515
76,1083,1121,2204,1938,40,1055,281,412,610
76,1085,1145,2230,1953,39,1057,288,428,582
76,1229,1259,2488,2220,46,1206,393,510,716
76,1440,1277,2717,2078,411,1444,437,510,729
76,1455,1323,2778,2095,395,1453,447,518,756
76,1484,1285,2769,2144,408,1510,512,516,757
76,1605,1586,3191,2277,685,1792,467,513,853
76,1638,1615,3253,2295,681,1754,474,578,901
76,1673,1677,3350,2400,680,1888,486,540,911
76,1964,1687,3651,2527,812,1988,511,580,971
76,2016,1971,3987,3382,222,1954,529,712,1052
76,2023,1712,3735,2552,888,2051,578,624,959
76,2028,1697,3725,2558,862,2065,514,598,987
76,2057,2002,4059,3491,200,2020,623,736,1131
76,2100,1999,4099,3567,228,2051,615,779,1170
76,3599,3406,7005,5042,1421,3860,1010,1095,1940
76,3723,3413,7136,5135,1455,4019,1079,1121,1880
76,3727,3359,7086,5070,1483,3982,997,1103,1896
76,7504,6592,14096,9793,2758,7846,2054,2243,3608
76,7530,6539,14069,9716,2830,7778,2083,2288,3633
76,7796,6933,14729,10296,2831,8188,2157,2354,3793
76,7811,6871,14682,10196,2899,8110,2173,2372,3799
76,7817,6662,14479,9950,2993,7931,2121,2388,3784
76,8096,6998,15094,10413,3066,8247,2190,2476,3964
76,11469,10720,22189,17191,2925,11629,3090,3862,5946
76,11795,10858,22653,17466,3034,11891,3207,3912,6045
76,12021,11121,23142,18214,3040,12453,3398,4021,6261
77,453,549,1002,729,191,566,161,154,347
77,455,558,1013,755,192,578,179,155,346
77,482,571,1053,756,201,569,146,164,361
77,573,614,1187,811,262,652,182,153,345
77,593,650,1243,885,254,700,220,157,368
77,602,763,1365,1013,210,697,206,207,443
77,647,782,1429,1100,203,778,238,223,457
77,652,795,1447,1083,211,724,249,230,499
77,675,679,1354,939,254,653,215,193,384
77,680,648,1328,925,264,652,210,207,348
77,680,688,1368,934,286,769,244,187,403
77,703,694,1397,981,222,711,196,196,417
77,713,773,1486,1071,307,846,250,216,461
77,718,696,1414,998,211,721,212,215,416
77,726,708,1434,993,267,716,222,209,434
77,731,783,1514,1066,324,838,224,201,452
77,756,844,1600,1118,366,868,237,237,549
77,766,871,1637,1057,435,913,288,240,485
77,779,837,1616,1094,399,943,298,228,458
77,808,748,1556,1062,255,759,223,232,468
77,862,801,1663,1133,353,856,272,274,452
77,862,920,1782,1176,461,1012,298,285,511
77,878,836,1714,1172,374,896,319,260,468
77,920,963,1883,1342,379,1029,338,272,522
77,938,948,1886,1342,368,1020,267,288,525
77,1002,927,1929,1254,444,1003,333,274,541
77,1075,1206,2281,1622,489,1294,398,323,715
77,1086,1094,2180,1425,572,1212,326,302,612
77,1094,1022,2116,1481,427,1135,308,325,604
77,1108,1143,2251,1546,515,1280,332,289,699
77,1121,1103,2224,1460,576,1211,367,305,613
77,1148,1182,2330,1517,588,1253,363,354,730
77,1149,1174,2323,1389,760,1349,399,316,690
77,1151,1197,2348,1382,753,1354,405,322,661
77,1226,1256,2482,1464,806,1430,417,351,718
77,1249,1289,2538,1696,595,1412,437,360,810
77,1291,1379,2670,1676,807,1583,444,376,935
77,1319,1302,2621,1664,764,1575,484,349,892
77,1361,1483,2844,1717,863,1611,466,403,999
77,1399,1409,2808,1901,682,1543,514,479,830
77,1408,1451,2859,1900,728,1570,515,473,885
77,1474,1324,2798,1479,1070,1644,438,341,782
77,1561,1570,3131,2098,775,1723,549,536,943
77,1594,1307,2901,1543,1140,1749,469,383,721
77,1639,1375,3014,1537,1206,1728,481,405,822
77,1743,1683,3426,2293,817,1905,539,411,971
77,1799,1712,3511,2363,852,2041,605,391,1025
77,1939,1875,3814,2484,921,2080,648,491,1189
77,2329,2433,4762,3134,1160,2639,755,622,1453
77,2438,2473,4911,3285,1239,2788,824,694,1492
77,2471,2340,4811,2764,1679,2890,815,681,1419
77,2519,2365,4884,2758,1708,2906,780,683,1422
77,2574,2699,5273,3425,1316,2917,810,714,1719
77,2763,2652,5415,3005,1956,3187,900,807,1652
77,3158,3212,6370,4168,1731,3691,1054,906,1980
77,3230,3228,6458,4280,1679,3725,1178,966,2022
77,3477,3404,6881,4459,1778,3841,1096,1036,2179
77,3620,3514,7134,4153,2439,4239,1214,997,2109
77,3670,3562,7232,4140,2461,4260,1185,1005,2083
77,3989,3908,7897,4469,2762,4617,1317,1158,2370
78,351,366,717,497,151,395,92,80,229
78,364,373,737,514,162,406,122,80,229
78,370,282,652,381,221,381,111,76,170
78,378,318,696,428,210,393,113,102,179
78,396,289,685,409,228,407,113,88,180
78,400,414,814,564,161,419,130,102,274
78,432,426,858,588,178,441,132,83,218
78,452,439,891,627,184,481,144,99,245
78,496,488,984,706,192,524,165,125,287
78,535,537,1072,649,331,602,159,139,344
78,609,543,1152,737,334,651,209,174,353
78,617,685,1302,970,215,732,223,176,392
78,621,600,1221,772,340,665,222,186,379
78,631,648,1279,940,224,703,227,167,357
78,738,735,1473,1049,283,822,234,198,427
78,972,906,1878,1100,639,1169,322,217,558
78,1007,999,2006,1407,404,1144,299,256,553
78,1010,957,1967,1142,666,1207,339,220,585
78,1030,1028,2058,1486,421,1234,348,262,562
78,1093,1056,2149,1386,588,1269,331,291,640
78,1110,1158,2268,1566,480,1270,354,322,703
78,1117,1248,2365,1553,540,1291,359,298,699
78,1119,1226,2345,1651,451,1361,352,272,696
78,1119,1258,2377,1685,460,1381,362,289,712
78,1123,1036,2159,1339,653,1277,310,296,647
78,1129,1072,2201,1241,761,1356,337,245,646
78,1152,1212,2364,1586,543,1307,410,304,679
78,1255,1127,2382,1449,762,1428,347,323,720
78,1265,1241,2506,1655,651,1490,397,339,762
78,1270,1345,2615,1762,553,1480,433,340,783
78,1294,1279,2573,1742,652,1562,421,352,815
78,1300,1316,2616,1716,609,1410,427,370,770
78,1427,1334,2761,1793,754,1652,425,365,847
78,1715,1902,3617,2297,1001,2162,582,380,1142
78,1753,1877,3630,2222,1042,2108,569,438,1157
78,1955,1994,3949,2340,1188,2277,591,449,1228
78,2173,1862,4035,2510,1254,2387,667,527,1171
78,2184,1884,4068,2521,1272,2387,666,532,1186
78,2353,2021,4374,2652,1416,2570,721,578,1272
78,2423,2332,4755,3028,1346,2664,744,511,1464
78,2450,2285,4735,3037,1277,2562,713,545,1394
78,2565,2497,5062,3178,1407,2721,849,607,1598
78,2854,2058,4912,2732,1886,2963,853,639,1358
78,2865,2018,4883,2599,1979,2919,804,615,1344
78,3136,2139,5275,2816,2114,3139,790,719,1458
78,3522,2769,6291,3779,2071,3665,948,836,1811
78,3578,2895,6473,3918,2104,3833,1126,845,1916
78,3656,2888,6544,3840,2171,3730,996,869,1941
79,516,589,1105,836,172,563,178,195,296
79,669,795,1464,1108,183,709,214,233,310
79,711,835,1546,1172,201,738,240,269,378
79,935,876,1811,1296,330,928,261,345,361
79,973,861,1834,1266,378,930,287,336,333
79,1026,898,1924,1277,445,986,304,336,370
79,2983,2986,5969,4406,760,3025,854,930,1345
79,3051,3018,6069,4535,774,3059,916,966,1437
79,3106,3152,6258,4766,752,3263,972,1016,1519
80,1634,1481,3115,2628,84,1436,455,583,793
80,1647,1448,3095,2656,75,1460,461,603,797
80,1654,1588,3242,2813,80,1542,470,656,882
80,9193,8229,17422,13092,2458,9511,2443,2797,4444
80,9363,8120,17483,13067,2520,9453,2490,2822,4442
80,9750,9024,18774,14311,2614,10360,2798,3166,5116
81,308,287,595,431,75,267,80,85,148
81,316,346,662,491,93,291,103,117,180
81,320,298,618,443,81,276,73,97,146
81,584,572,1156,912,108,569,178,179,296
81,603,561,1164,923,114,560,173,202,303
81,603,580,1183,920,126,571,170,194,327
81,827,902,1729,1374,180,913,237,225,450
81,828,819,1647,1277,212,834,214,210,445
81,850,946,1796,1389,195,936,287,254,480
81,854,855,1709,1313,215,835,244,240,473
81,910,972,1882,1468,213,954,253,263,485
81,912,890,1802,1414,213,923,261,236,481
81,2269,2436,4705,3654,461,2205,671,772,1264
81,2281,2496,4777,3665,440,2239,687,760,1302
81,2371,2568,4939,3903,437,2440,771,816,1351
81,2701,2890,5591,4019,746,2716,771,909,1530
81,2775,2951,5726,4073,753,2782,802,886,1556
81,2778,2948,5726,4222,738,2882,860,942,1556
82,1327,1101,2428,1032,1201,1401,366,325,675
82,1337,1110,2447,992,1309,1445,330,317,665
82,1515,1261,2776,1061,1596,1648,348,392,856
82,3634,3815,7449,5241,1419,3951,1065,1112,2076
82,3788,4086,7874,5572,1527,4290,1175,1207,2251
82,3822,3941,7763,5383,1499,4013,1063,1204,2196
83,442,510,952,748,111,475,138,140,302
83,475,502,977,757,132,514,152,126,304
83,480,539,1019,769,132,510,145,139,294
83,518,667,1185,938,102,600,176,154,368
83,545,671,1216,963,104,620,163,166,372
83,546,677,1223,970,101,593,186,184,379
83,987,1069,2056,1620,113,978,251,285,569
83,1046,1083,2129,1646,109,987,296,315,564
83,1050,1092,2142,1746,122,1058,284,313,604
83,1076,1104,2180,1714,250,1156,321,327,632
83,1084,1167,2251,1737,244,1152,358,352,647
83,1093,1134,2227,1711,259,1156,307,336,634
83,2112,2231,4343,3333,470,2125,605,662,1264
83,2192,2282,4474,3425,464,2199,636,673,1258
83,2253,2375,4628,3538,467,2305,691,709,1343
83,2813,3030,5843,4667,479,2865,745,830,1727
83,2876,3069,5945,4821,474,2960,818,838,1752
83,3024,3190,6214,5044,494,3181,753,884,1818
83,3184,3262,6446,4806,827,3123,914,877,1935
83,3283,3442,6725,5324,628,3366,965,1004,1890
83,3334,3305,6639,4970,788,3193,992,882,2031
83,3375,3299,6674,5097,852,3368,857,887,2009
83,3469,3568,7037,5523,655,3482,1026,1101,1956
83,3477,3628,7105,5748,644,3665,1032,1083,2058
83,8741,8663,17404,13161,2187,8882,2422,2435,4744
83,8923,8798,17721,13389,2221,9024,2615,2587,4898
83,9357,9085,18442,14189,2308,9713,2823,2640,5107
84,612,588,1200,894,185,587,190,183,289
84,633,586,1219,902,190,594,163,175,298
84,648,613,1261,937,193,624,170,194,303
84,673,874,1547,1155,172,748,222,234,419
84,689,859,1548,1227,167,751,243,288,465
84,727,884,1611,1201,201,782,226,242,455
84,747,757,1504,1128,235,781,204,214,444
84,798,739,1537,1167,248,830,234,210,455
84,799,773,1572,1175,241,784,214,216,442
84,949,937,1886,1333,366,925,281,279,505
84,982,962,1944,1422,380,1016,286,311,553
84,987,984,1971,1350,390,946,260,291,523
84,1093,1180,2273,1759,265,1155,333,281,624
84,1098,1214,2312,1785,205,1128,338,354,631
84,1106,1213,2319,1831,207,1177,345,363,659
84,1109,1056,2165,1560,385,1144,340,327,612
84,1119,1080,2199,1669,338,1193,352,331,630
84,1120,1239,2359,1858,281,1257,370,297,696
84,1138,1200,2338,1817,264,1157,324,307,667
84,1182,1028,2210,1611,376,1165,315,329,591
84,1189,1293,2482,1946,198,1231,394,391,666
84,1218,1286,2504,1947,339,1350,363,412,721
84,1258,1301,2559,1981,322,1358,370,410,730
84,1263,1292,2555,2006,340,1380,406,447,738
84,1870,2044,3914,2833,709,2033,551,545,1138
84,1951,2022,3973,3026,703,2144,637,611,1187
84,1961,2103,4064,2933,745,2110,623,572,1179
84,2305,2114,4419,2598,1458,2354,674,627,1221
84,2310,2189,4499,2754,1423,2432,701,672,1295
84,2356,2209,4565,2632,1519,2419,650,644,1242
84,2358,2164,4522,2927,1095,2325,691,654,1199
84,2400,2177,4577,3082,1120,2455,730,669,1310
84,2464,2221,4685,3032,1120,2453,664,635,1270
84,7778,6881,14659,9852,3447,8099,2206,1962,4158
84,8016,6936,14952,10161,3477,8352,2283,2097,4303
84,8225,7152,15377,10254,3554,8423,2214,2003,4317
85,742,737,1479,1192,113,690,207,250,361
85,748,770,1518,1242,100,744,226,225,389
85,781,710,1491,1210,100,679,209,251,328
85,3238,3397,6635,4946,936,3450,1037,1123,1639
85,3243,3380,6623,4817,1016,3374,947,1104,1653
85,3425,3362,6787,4880,1108,3444,962,1147,1619
86,1687,1726,3413,2600,430,1684,501,581,830
86,1736,1742,3478,2743,414,1715,542,609,858
86,1813,1747,3560,2741,460,1731,567,645,864
86,4638,4495,9133,6427,1470,4914,1295,1608,2106
86,4834,4667,9501,6697,1529,5056,1402,1755,2268
86,4860,4647,9507,6851,1481,5202,1422,1710,2267
86,4876,4794,9670,6838,1510,5170,1352,1700,2241
86,5027,4970,9997,7105,1561,5408,1418,1742,2321
86,5078,4984,10062,7150,1569,5334,1477,1848,2394
86,5093,4970,10063,7298,1514,5488,1503,1791,2405
86,5271,5149,10420,7399,1636,5565,1532,1911,2500
86,5319,5160,10479,7635,1574,5728,1586,1894,2489
87,7210,7010,14220,9325,3172,7502,2089,2380,3682
87,7576,7174,14750,9591,3298,7617,2095,2523,3846
87,7594,7383,14977,9991,3265,8190,2313,2479,3997
88,462,460,922,737,61,417,141,132,235
88,470,472,942,743,79,406,126,159,263
88,484,477,961,750,81,444,141,128,253
88,501,512,1013,816,52,499,168,143,278
88,507,538,1045,863,46,518,146,155,297
88,522,512,1034,855,54,526,144,140,284
88,1357,1244,2601,2134,237,1324,344,416,712
88,1396,1207,2603,2068,266,1299,354,397,658
88,1402,1260,2662,2109,257,1302,371,412,674
88,1961,1749,3710,2780,400,1826,504,537,975
88,2027,1817,3844,2988,387,1938,557,586,1056
88,2098,1828,3926,2940,445,1924,551,607,1033
89,427,403,830,628,133,417,138,179,195
89,427,410,837,629,117,422,150,162,205
89,445,425,870,638,158,464,158,159,222
89,538,509,1047,774,201,566,170,160,290
89,549,527,1076,766,222,566,168,168,278
89,585,530,1115,783,233,586,161,171,266
89,1626,1711,3337,2371,674,1851,546,527,898
89,1632,1654,3286,2263,709,1818,535,489,921
89,1708,1651,3359,2371,699,1868,546,541,895
89,1843,1828,3671,2710,559,1860,551,593,929
89,1849,1911,3760,2838,521,1949,525,604,918
89,1917,1828,3745,2803,575,1876,615,659,860
90,471,471,942,756,86,484,155,137,258
90,486,474,960,763,82,496,158,144,249
90,509,488,997,786,101,533,154,154,250
90,3078,2789,5867,4266,966,3190,930,862,1583
90,3126,2757,5883,4249,1064,3185,922,890,1574
90,3302,2998,6300,4614,1015,3409,1002,927,1695
90,3329,2982,6311,4590,1115,3396,989,962,1697
90,3552,2824,6376,4464,1185,3374,1076,1002,1609
90,3767,3069,6836,4813,1233,3589,1144,1086,1734
91,210,265,475,333,107,281,83,66,151
91,211,270,481,335,104,261,88,82,156
91,223,315,538,350,137,291,87,85,182
91,356,419,775,526,181,421,126,122,225
91,366,398,764,513,182,412,126,125,231
91,387,475,862,527,232,522,154,124,291
91,396,473,869,557,238,541,154,141,294
91,398,411,809,547,185,433,137,135,234
91,425,476,901,553,257,548,173,136,298
91,575,517,1092,686,309,630,169,135,282
91,608,510,1118,694,313,619,185,156,294
91,632,741,1373,872,371,751,221,179,443
91,663,589,1252,786,339,687,199,180,351
91,686,641,1327,767,441,739,235,193,369
91,690,642,1332,783,436,751,225,192,375
91,694,676,1370,818,428,744,242,200,388
91,742,855,1597,1078,356,901,253,209,464
91,859,882,1741,1117,440,969,296,237,486
91,900,932,1832,1211,455,1036,312,236,510
91,901,953,1854,1226,439,1051,321,238,536
91,905,876,1781,1155,459,965,269,244,499
91,909,967,1876,1260,435,1071,286,251,563
91,932,984,1916,1200,500,1053,315,281,576
91,955,974,1929,1275,437,1029,305,252,566
91,969,951,1920,1212,562,1051,306,264,593
91,972,950,1922,1201,574,1047,303,261,581
91,1001,942,1943,1220,534,1059,334,247,527
91,1062,1023,2085,1290,602,1118,343,286,639
91,1091,1194,2285,1468,603,1294,372,354,661
91,1099,1206,2305,1548,564,1323,402,384,682
91,1231,1154,2385,1421,769,1391,379,274,696
91,1235,1272,2507,1635,632,1415,426,403,740
91,1279,1291,2570,1679,647,1449,395,377,730
91,1282,1164,2446,1459,782,1424,396,304,670
91,1293,1219,2512,1616,673,1424,390,359,709
91,1327,1471,2798,1702,815,1563,445,366,891
91,1327,1481,2808,1693,852,1635,446,355,881
91,1350,1455,2805,1776,785,1501,451,367,840
91,1361,1318,2679,1702,715,1463,441,434,808
91,1378,1496,2874,1848,801,1582,449,455,864
91,1406,1282,2688,1597,859,1533,448,356,793
91,1412,1487,2899,1873,768,1550,484,446,862
91,1431,1404,2835,1765,809,1517,437,365,775
91,1448,1455,2903,1818,771,1568,472,352,796
91,1486,1622,3108,1867,930,1795,478,364,947
91,1500,1593,3093,1940,878,1661,532,436,985
91,1514,1473,2987,1839,792,1533,497,430,804
91,1525,1594,3119,1840,981,1763,531,384,991
91,1541,1682,3223,1986,970,1866,567,401,988
91,1571,1570,3141,1952,892,1640,538,528,963
91,1692,1633,3325,1622,1457,1828,562,440,1013
91,1705,1543,3248,1915,895,1663,530,444,917
91,1743,1748,3491,2104,1037,1975,630,456,1062
91,1824,1672,3496,1658,1583,1985,664,441,1026
91,1917,1712,3629,1758,1614,1986,636,489,1105
91,2113,2066,4179,2506,1261,2510,669,433,1221
91,2144,2017,4161,2443,1254,2469,652,414,1150
91,2347,2447,4794,3060,1363,2633,755,719,1457
91,2384,2437,4821,3074,1342,2597,787,707,1443
91,2397,2622,5019,3381,1233,2739,800,763,1499
91,2402,2199,4601,2743,1395,2704,756,526,1338
91,2428,2593,5021,3372,1198,2677,810,735,1494
91,2633,2593,5226,3242,1494,2758,881,814,1602
91,2700,2791,5491,3575,1367,2798,907,921,1686
91,3034,3024,6058,3630,1901,3541,1081,759,1761
91,3065,2820,5885,3485,1944,3426,1021,836,1646
91,3079,2785,5864,3312,1904,3289,960,800,1596
91,3180,3187,6367,3418,2392,3552,1107,820,1882
91,3210,2860,6070,3462,2009,3427,1047,868,1709
91,3267,3077,6344,3835,1997,3657,1095,905,1788
91,3275,3250,6525,3519,2512,3766,1191,845,1951
91,3281,3053,6334,3662,1961,3529,1037,855,1733
91,3436,3125,6561,3825,2069,3665,1122,931,1854
91,3554,3447,7001,3788,2635,3885,1214,972,2159
91,3565,3709,7274,4348,2252,4118,1215,949,2187
91,3666,3765,7431,4502,2272,4292,1302,938,2204
91,4071,3880,7951,4643,2458,4438,1296,1052,2383
92,1228,1390,2618,1799,571,1437,395,261,846
92,1290,1384,2674,1889,577,1516,436,279,867
92,1370,1470,2840,1986,602,1578,460,305,940
92,1495,1508,3003,1957,835,1739,440,302,1041
92,1508,1532,3040,1997,842,1765,511,358,1024
92,1589,1597,3186,2127,846,1806,486,392,1155
92,2006,2104,4110,2908,850,2320,689,426,1213
92,2046,2117,4163,2881,861,2334,661,392,1202
92,2279,2336,4615,3191,928,2548,701,512,1403
92,2358,2284,4642,2927,1345,2705,686,452,1464
92,2380,2296,4676,2981,1340,2775,847,436,1474
92,2554,2505,5059,3211,1481,2950,781,548,1671
92,2950,2749,5699,3680,1669,3189,881,648,1903
92,3121,2766,5887,3785,1757,3330,991,661,1897
92,3204,2840,6044,3859,1728,3290,846,717,1938
92,3449,3352,6801,4396,1897,3977,1004,622,2135
92,3580,3354,6934,4452,2004,4164,1145,599,2115
92,3653,3533,7186,4670,1889,4107,1107,714,2278
92,4017,4105,8122,5290,1976,4585,1293,676,2569
92,4071,4109,8180,5271,2011,4588,1339,692,2553
92,4443,4460,8903,5867,2061,4907,1315,873,2942
92,4492,4173,8665,5435,2426,4788,1349,851,2670
92,4617,4252,8869,5573,2521,4916,1466,885,2707
92,4855,4424,9279,5950,2541,5137,1457,1026,2928
92,5259,4940,10199,6482,2959,5838,1655,1119,3161
92,5299,4867,10166,6551,2803,5714,1690,1156,3039
92,5579,5314,10893,6995,2970,6164,1687,1259,3528
92,6967,6854,13821,8970,3645,7774,2174,1324,4472
92,7192,6875,14067,9056,3768,7918,2330,1353,4450
92,7647,7300,14947,9726,3789,8197,2161,1590,4880
93,560,530,1090,691,330,627,179,127,326
93,569,534,1103,682,361,638,180,120,359
93,597,593,1190,779,346,705,184,163,394
93,602,644,1246,809,352,734,171,171,448
93,623,567,1190,709,398,680,188,130,386
93,625,595,1220,799,339,713,210,166,379
93,741,673,1414,839,471,794,239,196,466
93,757,706,1463,882,499,837,231,198,501
93,802,735,1537,923,496,848,244,243,532
93,866,701,1567,739,713,850,237,173,442
93,891,721,1612,780,717,909,266,183,467
93,925,704,1629,788,726,889,266,192,485
93,1672,1741,3413,2178,987,1989,538,421,1117
93,1677,1763,3440,2196,993,2005,568,417,1117
93,1701,1848,3549,2208,1053,1989,606,422,1178
93,1785,1850,3635,2294,1090,2071,577,455,1220
93,1854,1871,3725,2295,1120,2042,572,478,1235
93,1868,1862,3730,2375,1035,2091,629,512,1234
93,1911,1628,3539,1881,1441,1987,569,451,1120
93,1911,1842,3753,2538,897,1993,600,577,1176
93,1912,1717,3629,2479,925,2121,603,356,1065
93,1919,1708,3627,2493,886,2122,541,338,1009
93,1932,1719,3651,1919,1512,2095,666,445,1173
93,1947,1881,3828,2667,889,2072,669,607,1199
93,1966,1968,3934,2534,1065,2139,597,583,1279
93,2001,2007,4008,2693,1072,2263,717,627,1320
93,2036,1973,4009,2706,955,2101,704,633,1285
93,2088,1872,3960,2669,1008,2296,583,410,1173
93,2113,2162,4275,2753,1123,2283,690,686,1448
93,2147,1776,3923,2039,1616,2194,661,512,1252
93,2345,2262,4607,3127,1272,2750,797,454,1376
93,2359,2293,4652,2891,1343,2765,718,473,1436
93,2396,2263,4659,2998,1309,2797,798,542,1396
93,2442,2299,4741,2593,1822,2631,765,654,1556
93,2445,2296,4741,3189,1274,2767,712,473,1404
93,2477,2331,4808,2701,1807,2726,831,644,1608
93,2598,2476,5074,3095,1687,2960,762,522,1636
93,2640,2458,5098,3149,1486,3007,880,582,1615
93,2690,2433,5123,3448,1359,2975,780,510,1537
93,2745,2563,5308,3231,1776,3134,851,567,1667
93,2802,2424,5226,2880,1989,2848,886,785,1712
93,2847,2644,5491,3302,1848,3184,897,605,1779
93,2951,3106,6057,4005,1566,3376,996,733,1902
93,3024,2740,5764,3211,2190,3141,990,864,1817
93,3034,3189,6223,4142,1624,3593,1041,712,1989
93,3091,2788,5879,3339,2204,3274,1053,897,1891
93,3197,3112,6309,3792,1981,3499,964,718,2142
93,3234,2877,6111,3460,2299,3327,1040,938,2017
93,3239,3023,6262,3611,2316,3405,1000,921,2035
93,3304,2982,6286,3631,2310,3461,1027,862,2057
93,3308,3213,6521,3972,2107,3714,1148,784,2133
93,3329,3418,6747,4424,1757,3798,1160,843,2274
93,3423,3287,6710,4043,2140,3643,1056,864,2324
93,3424,3196,6620,3974,2238,3644,1070,824,2257
93,3426,3279,6705,4061,2263,3786,1055,823,2203
93,3452,3092,6544,4255,1825,3882,962,613,1896
93,3530,3179,6709,4339,1941,4068,1059,611,1964
93,3589,3239,6828,3870,2523,3697,1124,1015,2296
93,3640,3379,7019,4210,2392,3947,1126,888,2348
93,3688,3423,7111,4231,2468,3948,1160,925,2473
93,3701,3382,7083,4513,2133,4221,1101,584,2083
93,3755,3386,7141,4588,2006,4222,1090,716,2164
93,3755,3501,7256,4345,2474,4143,1196,906,2354
93,3776,3445,7221,4384,2431,3957,1162,861,2434
93,3798,3437,7235,4481,2324,4372,1151,602,2113
93,3937,3605,7542,4642,2532,4259,1280,883,2538
93,3944,3652,7596,4524,2614,4241,1159,976,2635
93,4030,3704,7734,4952,2261,4582,1205,751,2386
93,4097,3722,7819,4658,2653,4179,1274,1023,2698
93,4353,3927,8280,4474,3263,4618,1334,1105,2676
93,4409,4050,8459,4620,3319,4821,1497,1089,2781
93,4753,4464,9217,5606,2971,5040,1485,1137,3071
93,4758,4540,9298,5704,3030,5197,1462,1163,3018
93,4769,4488,9257,6075,2617,5543,1419,771,2727
93,4949,4200,9149,4919,3605,5042,1547,1297,2964
93,4972,4516,9488,6133,2802,5792,1490,799,2744
93,5140,4834,9974,6030,3288,5500,1609,1280,3394
93,5200,4852,10052,6577,2800,5970,1519,966,3104
93,6819,6231,13050,7815,4477,7199,2104,1586,4388
93,6987,6344,13331,7896,4713,7435,2172,1509,4451
93,7067,6511,13578,8188,4667,7689,2266,1623,4513
93,7216,6606,13822,8240,4866,7837,2306,1584,4606
93,7439,6730,14169,8373,4915,7686,2262,1828,4885
93,7489,6298,13787,7919,5034,8124,2230,1498,4162
93,7556,6714,14270,8322,5041,7745,2304,1794,4847
93,7628,6523,14151,8211,5250,8471,2271,1597,4336
93,7849,7170,15019,9011,5121,8146,2352,2190,4832
93,7997,7202,15199,9151,5211,8392,2531,2111,4896
93,8024,6788,14812,8530,5378,8563,2374,1757,4702
93,8186,7105,15291,10368,4169,9220,2462,1357,4093
93,8199,7140,15339,10301,4150,9055,2228,1376,4055
93,8662,7674,16336,9754,5561,8769,2728,2512,5427
93,8705,7582,16287,10931,4406,9566,2479,1544,4577
93,9400,7926,17326,9800,6475,10111,2799,1949,5282
93,9560,8242,17802,10130,6762,10566,2937,2042,5509
93,9931,8597,18528,10512,6856,10755,2995,2152,5718
93,10105,8854,18959,10912,7057,11197,3102,2241,5944
93,10171,8564,18735,10569,6994,10757,3035,2269,5954
93,10531,9367,19898,13495,5441,11970,3259,1811,5469
93,10644,9436,20080,13490,5424,11822,2940,1849,5459
93,10826,9212,20038,11410,7367,11411,3260,2542,6414
93,11395,10015,21410,14379,5765,12541,3259,2054,6114
93,12276,11357,23633,14012,8253,13324,3784,2719,7864
93,12580,11749,24329,14436,8508,13928,3918,2831,7913
93,12716,11324,24040,15889,6723,14137,3531,2236,6700
93,12843,11385,24228,16078,6870,14475,3916,2280,6825
93,12950,10739,23689,13280,8962,13658,3772,2302,7054
93,13240,11098,24338,13379,9508,14195,3955,2422,7302
93,13336,12067,25403,14912,8966,14205,4075,3106,8588
93,13640,12098,25738,16902,7262,15046,3959,2559,7529
93,14124,11483,25607,14190,9691,14600,4078,2791,7810
93,16107,12731,28838,15676,11301,16504,4567,3149,8463
93,16384,13267,29651,16120,11909,17319,4910,3277,8856
93,17436,13720,31156,16804,12299,17674,5024,3652,9494
94,798,809,1607,947,548,894,222,241,530
94,834,861,1695,1026,561,975,266,260,577
94,862,885,1747,1123,477,941,277,283,574
94,867,848,1715,966,612,940,272,242,567
94,928,902,1830,1174,510,1001,307,318,582
94,972,950,1922,1236,525,1044,334,303,636
94,982,993,1975,1310,519,1120,259,214,608
94,1029,1023,2052,1386,521,1168,369,235,633
94,1060,1141,2201,1414,616,1230,333,297,729
94,1082,1199,2281,1459,574,1218,341,292,720
94,1083,1094,2177,1400,596,1215,363,249,700
94,1109,1202,2311,1457,632,1229,369,302,755
94,1132,1197,2329,1473,667,1318,415,312,767
94,1142,1170,2312,1511,589,1320,301,244,720
94,1150,1247,2397,1532,689,1333,366,337,823
94,1200,1205,2405,1602,633,1386,389,267,756
94,1238,1193,2431,1616,597,1369,396,305,752
94,1260,1304,2564,1583,778,1422,445,281,767
94,1265,1251,2516,1537,752,1344,379,291,728
94,1301,1159,2460,1548,692,1380,428,264,734
94,1302,1390,2692,1687,734,1451,450,367,907
94,1315,1113,2428,1534,668,1324,407,264,700
94,1371,1282,2653,1602,772,1389,415,336,828
94,1416,1348,2764,1728,769,1516,454,346,899
94,1867,1904,3771,2332,1073,2169,650,453,1208
94,1868,1813,3681,2484,927,2092,536,391,1116
94,1895,1886,3781,2402,1050,2198,616,508,1165
94,1920,1878,3798,2560,940,2184,617,397,1153
94,1933,1820,3753,2545,961,2148,627,412,1124
94,1937,1870,3807,2013,1573,2133,664,598,1241
94,1942,1853,3795,2579,944,2201,582,403,1170
94,1959,1738,3697,1859,1570,2030,584,549,1169
94,2020,2125,4145,2558,1188,2374,705,536,1372
94,2067,1984,4051,2647,1080,2253,635,498,1275
94,2134,1824,3958,1929,1722,2158,644,587,1238
94,2157,2077,4234,2758,1137,2407,650,526,1362
94,2220,2199,4419,2592,1427,2540,694,508,1343
94,2264,2327,4591,3191,820,2342,747,429,1261
94,2278,2246,4524,3105,1055,2548,676,442,1303
94,2282,2274,4556,3172,775,2303,725,415,1257
94,2299,2283,4582,2740,1467,2667,750,558,1416
94,2305,2261,4566,3124,1065,2550,655,465,1316
94,2374,2281,4655,3145,1220,2633,699,507,1469
94,2409,2436,4845,2865,1569,2717,774,636,1572
94,2419,2373,4792,3255,1129,2616,709,534,1470
94,2468,2330,4798,3165,1290,2718,798,507,1442
94,2539,2584,5123,3540,887,2599,756,521,1540
94,2561,2446,5007,3290,1349,2839,792,548,1648
94,2785,2702,5487,3417,1639,3071,914,601,1694
94,2816,2674,5490,3448,1647,3156,917,616,1630
94,3117,3085,6202,3838,1853,3422,1020,771,2016
94,3452,3191,6643,3984,2196,3693,1006,734,2002
94,3568,3266,6834,4177,2213,3910,1137,737,1991
94,3655,3487,7142,4397,2126,3886,1159,883,2092
94,3685,3463,7148,4435,2107,3861,1119,909,2108
94,3795,3670,7465,4170,2695,4195,1192,1055,2391
94,3811,3431,7242,4271,2478,4095,1094,819,2288
94,3834,3880,7714,4459,2716,4440,1287,1147,2506
94,4037,3774,7811,4833,2323,4149,1300,1050,2429
94,4050,3953,8003,4954,2391,4415,1293,892,2422
94,4076,3978,8054,5031,2425,4578,1362,897,2397
94,4125,3930,8055,4407,2961,4480,1338,1140,2585
94,4166,4261,8427,5504,2213,4634,1442,1084,2730
94,4197,4194,8391,5345,2288,4659,1319,998,2756
94,4345,4194,8539,5297,2484,4621,1404,1079,2524
94,4406,4177,8583,5364,2480,4622,1367,1106,2543
94,4488,4367,8855,5440,2625,4811,1435,1107,2844
94,4696,4604,9300,5797,2616,5132,1426,1175,3088
94,4805,4541,9346,5838,2714,4952,1554,1268,2924
94,5200,4736,9936,5942,3353,5543,1595,1186,3145
94,5204,4660,9864,5731,3404,5424,1499,1159,3033
94,5606,4965,10571,6140,3623,5698,1682,1357,3340
95,327,405,732,487,188,403,102,110,256
95,338,411,749,486,197,393,121,129,242
95,408,412,820,534,215,454,126,137,265
95,645,707,1352,948,275,740,239,135,382
95,675,706,1381,999,268,746,236,147,398
95,706,744,1450,1006,328,801,212,183,436
95,707,792,1499,995,359,841,225,206,451
95,710,754,1464,931,429,867,270,208,441
95,711,701,1412,862,393,752,229,195,437
95,715,775,1490,1028,318,782,256,196,461
95,722,711,1433,893,406,774,262,202,449
95,736,818,1554,1043,356,851,232,228,487
95,745,784,1529,1051,376,868,232,204,475
95,749,780,1529,958,439,878,253,226,463
95,785,760,1545,1075,325,810,252,221,472
95,795,806,1601,977,473,857,267,244,535
95,804,911,1715,1157,404,960,303,253,541
95,827,800,1627,1020,464,892,266,250,488
95,959,954,1913,1317,458,1030,325,222,577
95,964,1063,2027,1457,340,1024,304,300,618
95,978,915,1893,1267,464,1033,286,199,546
95,987,1046,2033,1499,321,1043,319,279,585
95,991,975,1966,1302,472,1115,301,243,615
95,1052,1013,2065,1387,510,1187,359,262,643
95,1065,1176,2241,1586,378,1197,346,283,680
95,1076,1095,2171,1606,349,1109,336,367,641
95,1088,1170,2258,1641,384,1249,372,293,690
95,1118,1058,2176,1399,530,1205,344,295,669
95,1122,1002,2124,1387,533,1140,374,261,643
95,1234,1214,2448,1610,579,1315,382,272,719
95,1245,1304,2549,1772,470,1370,399,339,760
95,1285,1238,2523,1561,717,1414,388,307,746
95,1318,1246,2564,1749,564,1424,388,250,727
95,1328,1476,2804,2108,427,1583,447,374,879
95,1344,1440,2784,2073,441,1539,463,366,813
95,1398,1338,2736,1757,693,1484,431,329,830
95,1416,1272,2688,1732,737,1566,456,325,774
95,1445,1358,2803,1760,823,1602,486,353,871
95,1469,1516,2985,2285,456,1668,490,471,908
95,1507,1502,3009,1789,921,1656,481,380,933
95,1525,1477,3002,2094,617,1709,524,359,887
95,1528,1447,2975,2017,614,1656,461,327,844
95,1529,1434,2963,1793,919,1611,493,440,949
95,1544,1457,3001,1877,889,1652,530,433,934
95,1550,1599,3149,2051,843,1806,518,452,952
95,1581,1511,3092,1855,936,1768,529,347,906
95,1588,1683,3271,1987,1011,1745,470,564,1072
95,1595,1614,3209,2154,719,1764,515,414,977
95,1674,1668,3342,2111,902,1892,554,473,939
95,1695,1727,3422,2184,982,1991,605,504,1093
95,1715,1684,3399,2099,1029,1849,577,559,1023
95,1744,1519,3263,2002,1009,1776,621,487,1048
95,1826,1689,3515,2055,1119,1920,589,472,1114
95,1828,1835,3663,2198,1180,1951,666,672,1204
95,1844,1849,3693,2074,1371,2072,636,473,1228
95,1950,1893,3843,2168,1457,2237,650,487,1238
95,2040,1926,3966,2265,1479,2248,691,575,1327
95,2717,2532,5249,3490,1193,2903,815,575,1513
95,2762,2661,5423,3627,1193,2971,843,599,1563
95,2763,2633,5396,3677,1243,3062,948,612,1598
95,2824,2466,5290,2964,1923,2831,871,696,1614
95,2843,2723,5566,3843,1181,3133,912,609,1614
95,2884,2541,5425,3099,1990,3076,925,700,1680
95,2905,2867,5772,3840,1373,3140,920,753,1763
95,2988,2556,5544,3149,1996,2988,963,741,1754
95,2993,2952,5945,3911,1412,3248,946,743,1807
95,3831,3934,7765,4543,2521,4716,1174,952,2418
95,3900,3980,7880,4847,2424,4854,1339,971,2430
95,3905,3727,7632,4500,2644,4188,1246,1016,2535
95,4035,3984,8019,4755,2655,4397,1369,1102,2651
95,4111,3877,7988,4810,2725,4428,1316,1108,2621
95,4155,4049,8204,4941,2723,4625,1446,1117,2643
95,4227,3903,8130,4777,2850,4403,1373,1222,2724
95,4255,4143,8398,4873,2835,5129,1446,1099,2642
95,4502,4179,8681,5204,2890,4789,1546,1287,2904
95,6274,5878,12152,7196,3923,6798,1870,1342,3908
95,6541,6111,12652,7688,4136,7376,2159,1434,4067
95,6852,6230,13082,7745,4280,7249,2175,1604,4301
95,7781,7380,15161,8985,4844,8454,2351,1722,4841
95,8122,7622,15744,9543,5072,9144,2688,1781,4973
95,8678,7919,16597,9800,5399,9169,2764,2076,5415
97,2064,2199,4263,3890,50,2211,504,597,1567
97,2108,2128,4236,3852,51,2241,548,579,1569
97,2123,2134,4257,3956,39,2328,722,630,1623
97,2811,3360,6171,5606,108,3402,990,957,2441
97,2829,3453,6282,5511,109,3354,955,920,2424
97,2859,3530,6389,5586,117,3389,873,935,2380
97,2934,3259,6193,5470,115,3254,874,897,2287
97,2964,3227,6191,5679,109,3488,1100,915,2371
97,3008,3298,6306,5624,134,3346,828,920,2238
97,3331,3402,6733,6153,93,3564,1094,1068,2704
97,3386,3338,6724,6062,115,3483,929,1056,2614
97,3397,3463,6860,6189,119,3546,921,1087,2620
97,3947,4238,8185,7400,111,4440,1104,958,3027
97,3970,4233,8203,7280,298,4069,1106,1254,3319
97,3983,4278,8261,7567,122,4461,1041,957,3043
97,4003,4228,8231,7237,296,3972,1098,1261,3127
97,4072,4367,8439,7566,292,4355,1286,1275,3448
97,4083,4255,8338,7751,107,4698,1087,1029,3157
97,4447,4781,9228,8330,72,4576,1030,1036,3600
97,4474,4820,9294,8402,81,4764,1069,972,3701
97,4646,4977,9623,8770,73,4989,1380,1145,3864
97,5226,5226,10452,9322,255,5376,1439,1528,4031
97,5240,5286,10526,9499,263,5385,1370,1594,4021
97,5483,5312,10795,9749,269,5732,1812,1673,4169
97,5790,6661,12451,11470,169,6634,1525,1715,5049
97,5922,6829,12751,11828,174,6663,1540,1866,5085
97,5975,6861,12836,11963,156,6959,1775,1926,5261
97,7893,9447,17340,15416,188,8822,2304,2198,6733
97,7929,9461,17390,15395,202,8716,2220,2170,6703
97,8094,9650,17744,16031,184,9193,2899,2439,7070
97,9368,9745,19113,16466,428,9373,2129,2324,7030
97,9595,9840,19435,16705,393,9609,2248,2353,7248
97,9872,10207,20079,17504,394,10389,3166,2517,7762
97,10461,10886,21347,19365,259,11227,2751,2864,7559
97,10522,10642,21164,19067,226,11272,2898,2722,7406
97,10697,10903,21600,19752,256,11917,3122,2931,7772
97,13248,14194,27442,23447,1437,14245,3540,3622,10145
97,13400,14353,27753,23510,1497,14193,3451,3664,10054
97,13604,14333,27937,24806,1399,15263,4712,3898,10607
